fabianism	n
dragomanlâc	n
paleolitic	n
gamaterapie	f
crisolit	n
percaină	f
bismutină	f
separatism	n
chiromanţie	f
husitism	n
sericit	n
gigantitate	f
substanţialitate	f
sigilat	n
numerar	n
arterioscleroză	f
potroace	n
blenie	f
transfuzare	f
karibu	m
aclimatare	f
sacrosanctitate	f
normotermie	f
salata-iepurelui	f
cuţu	m
tomism	n
titanizare	f
musiu	m
laicism	n
adventism	n
jurnalistică	f
fiziolatrie	f
pânzucă	f
scriptomanie	f
pacienţă	f
paleoarheologie	f
proctologie	f
capacitare	f
apolinism	n
scânteiuţe	f
supraponderabilitate	f
senzoriu	n
tahipsihie	f
stoicism	n
gingirică	f
pluvial	n
fit	n
lactofermentaţie	f
aşchiere	f
adresabilitate	f
expresivitate	f
îngrămădeală	f
iută	f
lamaserie	f
cursivitate	f
carfologie	f
calorizare	f
miţuit	n
reinfecţie	f
rujă-de-toamnă	f
iatrofizică	f
mentolact	n
ecarisare	f
păpică	f
alexitimie	f
parathormon	m
creatinurie	f
gliptologie	f
acidizare	f
anemometrie	f
adermină	f
metafizică	f
carelaj	n
master	m
bâlină	f
politematism	n
posterioritate	f
cucurigu	n
calimeră	f
uzinaj	n
pristolnic	m
miocrom	n
vânturat	n
hanap	n
supranaturalism	n
cacadu	m
pritoceală	f
transcendentalitate	f
electrocorticografie	f
periodism	n
asomare	f
doamnă-mare	f
stefanian	n
anualitate	f
motricitate	f
terpinol	n
judecire	f
agmatologie	f
radioelectricitate	f
daimio	m
victimizare	f
melodică	f
eufuism	n
gastrulă	f
europiu	n
imprimatur	n
arameică	f
premuniţie	f
claritate	f
şiism	n
budala	f
păsare	f
cărturărime	f
colinesterază	f
elipticitate	f
extensometrie	f
endemism	n
zooplancton	n
silicatizare	f
metageometrie	f
colesterol	m
citoliză	f
pagrus	m
prontozil	n
înfrăţire	f
split	n
turcime	f
plutitoare-dulce	f
refractaritate	f
termionică	f
năşit	n
sinecurism	n
rutişor	m
aculalie	f
gigolo	m
fortran	n
batigrafie	f
solzărie	f
manganin	n
impacienţă	f
declamativism	n
secară-cornută	f
endocinematografie	f
pesimism	n
rabdologie	f
ţarănime	f
binder	n
caprolactamă	f
eshatologie	f
mocănească	f
sincerică	f
geraniol	n
miogen	n
ghebri	m
ciclocefalie	f
săpunul-calului	n
dezmăţare	f
radarterapie	f
cumen	n
trăinicie	f
ratite	f
verde	n
homogeneză	f
embolit	n
etică	f
racul-pământului	n
oleoduc	n
eterogenie	f
nefropexie	f
trolit	n
oronimie	f
metalomorală	f
papă-lapte	m
anticolesterol	n
carangide	n
devon	m
fluxant	n
trânji	m
substituibilitate	f
morfiu	n
paleopatologie	f
radioterapie	f
cânepa-codrului	f
odinofagie	f
metamagnetism	n
dactiloscopie	f
pedodonţie	f
mobilism	n
anabioză	f
albaneză	f
organon	n
cherem	n
alicărie	f
pistol-rachetă	n
hegemonie	f
ladinian	n
diafanografie	f
daneză	f
coşărit	n
veridicitate	f
bionică	f
prohibiţionism	n
remaiat	n
xantină	f
stereomecanică	f
lactozurie	f
aciuare	f
picuţ	n
linţi	m
lutru	n
jumelaj	n
piezorezistivitate	f
protistologie	f
reinfestaţie	f
mitografie	f
minorat	n
locotenent-comandor	m
practicabilitate	f
francheţe	f
fenohartă	f
epidemiologie	f
oculus	n
intempestivitate	f
mango	m
şpec	n
pedobiont	n
tripleţi	m
organografie	f
turkmenă	f
sistematică	f
jir	n
septicitate	f
amofos	n
biculturism	n
generativism	n
dialectism	n
ciclomorfoză	f
tixotropie	f
deşteptat	n
greisen	n
coronografie	f
sărăcime	f
metilen	m
gorunişte	f
îngreunare	f
morărit	n
nominalism	n
morărie	f
profesiologie	f
delcredere	n
înot	n
celţiu	n
durăit	n
irezistibilitate	f
magnanerie	f
spoitorie	f
încazarmare	f
hamei	m
nemâncat	n
eclogit	n
parkinson	n
bumbăcit	n
mignon	n
solventare	f
galicanism	n
hidroizolaţie	f
nansuc	n
hiperemotivitate	f
almelec	n
frezat	n
bradipepsie	f
mărunţit	n
caloian	m
iepurariţă	f
târâire	f
însăilat	n
patogenicitate	f
tuliu	n
paratifos	n
zendă	f
surdopedagogie	f
tetrafonie	f
aminare	f
prozopologie	f
animologie	f
truvai	n
imoralism	n
introversiune	f
persană	f
reflexologie	f
acianopsie	f
retorism	n
obiectivitate	f
ihtiofaună	f
romanşă	f
runologie	f
hipertiroidism	n
nautism	n
prestidigitaţie	f
triiodotironină	f
pomişte	f
nenie	m
pozitroniu	n
durduit	n
proterozoic	n
recenţă	f
catalige	f
lungiş	n
pancalism	n
mamalogie	f
tămâioasă	f
ftori-stolnic	m
încrucişat	n
fie	f
înhăţare	f
azoturie	f
hidrobiologie	f
amoralism	n
sindactilie	f
cobol	n
guvernorat	n
ronron	n
prosperare	f
duluţă	f
bioritmologie	f
coprostază	f
idiotrofism	n
vetusteţe	f
incurabilitate	f
rusă	f
hipobaropatie	f
indult	n
clorid	n
teracot	n
dudgenare	f
murgit	n
radiocinematografie	f
vulcanism	n
hidrazobenzen	m
grus	n
ditroit	n
încolţit	n
lactoză	f
elinică	f
halografie	f
sindesmologie	f
cărăuşit	n
erijare	f
desocializare	f
subexpunere	f
vino-ncoace	n
molie-de-casă	f
piruit	n
ţuguiere	f
sfragistică	f
fizic	n
neuroendocrinologie	f
dormit	n
defavoare	f
comoraţie	f
argint-viu	n
neolingvistică	f
demimond	n
iranică	f
endocarst	n
termochimie	f
obosire	f
incomensurabilitate	f
cromatopsie	f
vaccinoterapie	f
lactoflavină	f
cisteină	f
impupare	f
sânger-pătat	m
conlocuire	f
nord	n
portochelari	m
amplifier	n
păstru	m
carbonarism	n
trăirism	n
prestigiu	n
pomeţi	m
accidentologie	f
ginofilie	f
bioinformatică	f
sclavagism	n
taclale	f
chineziologie	f
bărbărie	f
biospeologie	f
hasa	f
alcaliceluloză	f
audiofonologie	f
paştile-calului	m
prior	m
mixobacterii	f
rătutire	f
metilbenzen	m
factoring	n
bihun	n
percepţionism	n
stadialitate	f
orgenofilogeneză	f
alveolare	f
laicitate	f
ruralism	n
incoercibilitate	f
discofilie	f
aminozaharuri	n
merinozare	f
oceanologie	f
râia-broaştei	f
ianuarie	m
contubernalitate	f
banatit	n
mâncat	n
văcsuire	f
dotare	f
moţare	f
teapă	f
autogenie	f
anfractuozitate	f
peonaj	n
palidor	n
astatiniu	n
electrosomn	n
dromomanie	f
calul-popii	m
unisexualitate	f
hidrosferă	f
aerozină	f
delocutivitate	f
labrum	n
văruit	n
caustică	f
fatalism	n
hiolă	f
picior-de-gaiţă	n
ginecofobie	f
scizionism	n
sărare	f
baltistică	f
netitate	f
farmaceutică	f
sinclitism	n
aviasan	n
grandilocvenţă	f
vârstnicie	f
umanitarism	n
implantologie	f
salahorit	n
majolică	f
salahorie	f
poala-Maicii-Domnului	f
adenovirus	n
mioză	f
emanatism	n
ornitologie	f
efedrină	f
megaparsec	m
autoetanşare	f
graffiti	n
piei-roşii	f
antirealism	n
dijmărit	n
exempţiune	f
miau	n
epicureism	n
oxireducţie	f
incaso	n
etnofilie	f
neobişnuinţă	f
disten	n
ubicuitate	f
schepsis	n
odontoliză	f
glasbeton	n
cometofobie	f
canonicitate	f
seroprofilaxie	f
sunna	f
clamoare	f
coaxialitate	f
ratatinare	f
cutreierat	n
repetabilitate	f
internaţionale	f
lamarckism	n
paraşutism	n
gnozie	f
lă-mă-mamă	m
egocentrism	n
monohibridism	n
operozitate	f
widia	f
conimetrie	f
mecanoterapie	f
metaxenie	f
fulmicoton	n
gagarinit	n
valgus	n
substantivitate	f
fotometalografie	f
veziculografie	f
inamitate	f
muncuşoară	f
cirocumulus	m
comportism	n
arseniat	n
capacism	n
comensurabilitate	f
magnetobiologie	f
sociologism	n
cobaltare	f
maiestate	f
catihis	n
mozaism	n
toharică	f
lapiţi	m
inflexibilitate	f
luteţian	n
paşte-vânt	m
taxiologie	f
velarium	n
papirologie	f
coprostazie	f
ferodo	n
diaproiecţie	f
saprobiologie	f
educare	f
bun-simţ	n
sedimentologie	f
coloniale	f
camorra	f
trefilat	n
ortotropie	f
miatonie	f
ije	m
grăpat	n
ciobotecă	f
karateka	m
volumetrie	f
cupronichel	n
hidroponică	f
servilism	n
confesionalitate	f
rabotat	n
oxihemoglobină	f
sicativitate	f
biom	n
serpentinit	n
ectropion	n
dracon	n
depside	f
buha-semănăturilor	f
astrofotografie	f
bijecţie	f
sexualitate	f
mnemonică	f
stalinit	n
selectivitate	f
fotosensibil	n
dinamogeneză	f
biotomie	f
dolomită	f
termoconductibilitate	f
demorfism	n
pâinea-pădurii	f
proprietărime	f
densifigrafie	f
cobalt	n
geofizică	f
inclinometrie	f
organicitate	f
muscărime	f
osmiu	n
paneuropenism	n
criologie	f
asistolie	f
reşapare	f
astralism	n
sunat	n
lactaţie	f
cetoză	f
alotropism	n
mexicanistică	f
otologie	f
organdi	n
zăpăcire	f
misoneism	n
rea-voinţă	f
somnoroşie	f
corografie	f
tromel	n
deproteinizare	f
morfonologie	f
incomprehensiune	f
secară	f
ecofiziologie	f
humus	n
moare	f
triboluminescenţă	f
clinologie	f
zbânţuit	n
ruja-soarelui	f
profesură	f
transcorder	n
promptitudine	f
stroboscopie	f
stricat	n
idealitate	f
indiviziune	f
mondialism	n
antropomorfism	n
mezofile	n
viremie	f
bordo	n
buftea	m
odontologie	f
godiere	f
limbă-de-mare	f
fluorimetru	n
riţuit	n
criminalitate	f
lapţi	m
implacabilitate	f
ţârucă	f
litopon	n
iconologie	f
sesam	m
precipitabilitate	f
pricinuire	f
cromaj	n
cromal	n
palingenezie	f
cheratinizare	f
actiniu	n
eneacord	n
stalinism	n
haloizit	n
plutuit	n
megacolon	n
fenianism	n
niobiu	n
colodiu	n
căsăpire	f
paleoclimatologie	f
constituţionalitate	f
puerilism	n
igrasie	f
sericicultură	f
desinit	n
ciclamen	n
agililate	f
fosgen	n
straiul-broaştei	n
cosmobotanică	f
râie	f
pietruit	n
îmbrăcăminte	f
criminalizare	f
alexandrinism	n
pânzică	f
rodopsină	f
iraser	n
histeroscopie	f
xenografie	f
neuston	n
cardon	m
antropozofie	f
bastardare	f
terminat	n
jar	n
bielorusă	f
creiologie	f
lota	f
perlon	n
bădiţă	m
tandreţe	f
braghină	f
creson	n
ihtiofagie	f
lustruit	n
prolificitate	f
petulanţă	f
zvântat	n
clorofilă	f
conflictologie	f
brasaj	n
uniformitate	f
iodoform	n
bristol	n
ambrosaj	n
mucărit	n
stearină	f
cromatografie	f
polidimit	n
enotehnică	f
personologie	f
halterofilie	f
altruism	n
orzoaie	f
mirabilit	m
beri-beri	n
magnaliu	n
corhănit	n
argilizare	f
psihoenergetică	f
stanină	f
apolo	m
flămânzilă	m
neorealism	n
insolubilitate	f
carcinomatoză	f
progenie	f
voluntarism	n
anterioritate	f
voltol	n
arsenicism	n
perceptibilitate	f
pietism	n
tevatură	f
crup	n
psihanaliză	f
zoologie	f
devascularizare	f
egalitarism	n
fugato	n
actuariat	n
muzicalism	n
hidroacustică	f
antiton	n
permendur	n
autoconservare	f
crioluminescenţă	f
independenţă	f
suprasensibil	n
arhebioză	f
acetilenă	f
vtori-stolnic	m
perinerv	n
strofion	n
transsubstanţiere	f
broşiruire	f
binarism	n
disfonie	f
maori	m
termografie	f
cuişoare	n
încredere	f
coada-şoricelului	f
pulverulenţă	f
castitate	f
mimică	f
lenevit	n
strings	n
caricaturism	n
americiu	m
electrodinamică	f
calofilism	n
aprins	n
magnetit	n
porozitate	f
subiectivism	n
etnozoologie	f
arhaitate	f
ratafia	n
pasionalitate	f
zabrac	n
gazon	n
sfic	n
displazie	f
antisemitism	n
omnipotenţă	f
contractabilitate	f
adenopatie	f
nanoelectronică	f
talpa-stăncii	f
anovarie	f
moleşeală	f
beşamel	n
tangibilitate	f
delabializare	f
ruşală	f
acridide	f
batracocefalie	f
seismologie	f
taheometrie	f
kasolit	n
indelebilitate	f
calcipenie	f
mendeleeviu	n
februarie	m
incredibilitate	f
muscă-verde	f
sociometrie	f
aspermatism	n
jubilare	f
cafe-concert	n
impregnol	n
stricnină	f
partenofilie	f
afroamericanistică	f
ironism	n
politraumatism	n
geofizic	n
aventurism	n
teologizare	f
păcălit	n
paseism	n
humificare	f
etnogeneză	f
aerostatică	f
dintele-calului	m
epitaxie	f
coarctaţie	f
fiziometrie	f
azbociment	n
hoţit	n
dingo	m
psihosexologie	f
bolborosit	n
stovaină	f
ponderabilitate	f
adenină	f
corticoterapie	f
nefroză	f
absoluitate	f
psihic	n
germană	f
vizibilitate	f
hipometrie	f
incontinenţă	f
semigrup	n
eolizatie	f
dejugat	n
leucotaxină	f
uralit	n
holmiu	n
mumetal	n
extraneitate	f
flexografie	f
pegră	f
byronism	n
sapienţă	f
bonomie	f
papa-găinii	f
lup-de-mare	m
decurarizare	f
grafologie	f
toxicodermie	f
ungurime	f
ortofonie	f
aninare	f
cinorexie	f
potlogărit	n
floreal	n
şcolărime	f
tracologie	f
jumătate-de-pasăre	f
procustare	f
cloroform	n
verbozitate	f
klippă	f
filumenie	f
poliarhie	f
prostraţie	f
prelevaţie	f
emu	m
adipogeneză	f
rune	f
cheramzit	n
minţit	n
dunăre	f
multipol	m
anacronie	f
ginerie	f
pletismografie	f
hemotipologie	f
zoometrie	f
fitocitologie	f
plumbuit	n
logicism	n
ideofrenie	f
puricărie	f
ultramarin	n
androginie	f
galiard	n
balanus	m
ciupercărie	f
cianometru	n
rarificare	f
plebeiat	n
combinabilitate	f
sirtaki	n
gnu	m
clădit	n
efetonină	f
spectrometrie	f
artisticitate	f
nimfomanie	f
pădurărie	f
autocefalie	f
mezomerie	f
imelman	n
nevropatie	f
blanşisare	f
simplitate	f
cremocarp	m
cognat	m
fetiditate	f
meteorologie	f
caligrafiere	f
pelicanol	n
rumeguş	n
mancipaţie	f
înzecire	f
cavernometrie	f
bort	n
hataia	f
improbabilitate	f
esoterism	n
briard	m
bora	m
statisticism	n
arginază	f
selenodezie	f
reacţionarism	n
tupeu	n
promovabilitate	f
grizuscopie	f
sobrietate	f
percolare	f
îmbelşugare	f
graten	n
abiogeneză	f
opiu	n
unitarianism	n
dezgust	n
cosmologie	f
malţificare	f
silvină	f
cariometrie	f
paragenetică	f
imperceptibilitate	f
barocorie	f
cisticercoză	f
măturat	n
maximum	n
mamografie	f
rodonit	n
minifotbal	n
roneo	n
acetificare	f
agresare	f
cuterizare	f
cerşit	n
quattrocento	n
antren	n
lăfăire	f
parţi	m
africanizare	f
alani	m
salpetru	n
ghicit	n
giromanţie	f
tectonică	f
stejărişte	f
alfa	m
prozelitism	n
fasole	f
ecumenism	n
foaie-grasă	f
mei-tătăresc	m
encaust	n
ficoeritrină	f
reversibilitate	f
brânză-de-iepure	f
cioc-întors	m
crenologie	f
lastic	n
lepidocrocit	n
snobism	n
endogamie	f
treapăd	n
otrăvit	n
spanacul-ciobanilor	n
chemotactism	n
musterian	n
frige-linte	m
gigă	f
enilism	n
neodim	n
depeizare	f
încărunţire	f
chiu	n
nefelin	n
chil	n
melodism	n
augmentare	f
lăcărit	n
terbiu	n
ecrazită	f
corona	f
cardiomalacee	f
bauxită	f
antropogenie	f
estrogenie	f
pitiriazis	n
urodele	n
parodontologie	f
talasofobie	f
fabricitate	f
dinamită	f
astrobotanică	f
replat	n
americă	f
filigranologie	f
fibrină	f
planctologie	f
velografie	f
teism	n
vegetalin	n
electrocultură	f
morfofonologie	f
încuibare	f
nepa	f
creasta-cocoşului	f
retivitate	f
agonale	f
adrenalină	f
ţigănărit	n
adulterare	f
portlandian	n
anglofonie	f
aloxan	n
sfor	n
oleum	n
logomahie	f
imunosupresie	f
onomatologie	f
modularism	n
semiparazitism	n
şutat	n
sosit	n
cordoba	f
zeppă	f
mezi	m
zoolatrie	f
eicosan	n
frigiditate	f
morfină	f
bucolică	f
izmene	f
canabis	n
parsism	n
pritocit	n
acordabilitate	f
giardiază	f
dragster	n
aerogeologie	f
tăcut	n
endofagie	f
cirostratus	m
argumentabilitate	f
hiposulfit	m
vitelină	f
zebu	m
foliculină	f
câşlegi	f
botanografie	f
fluoren	n
bărduire	f
dintele-dracului	m
lături	f
imunohematologie	f
erbiu	n
amino	n
sărut-mâna	n
maximalism	n
preoţime	f
polifuncţionalitate	f
dibrometan	m
ortodiascopie	f
papagal-ţigănesc	m
toluare	f
decroş	n
heteropoliacizi	m
idolatrie	f
porunceală	f
mucus	n
simţiciune	f
calcipexie	f
arghirofilie	f
cănire	f
iască	f
teraz	n
sacrum	n
triasic	n
chemotaxie	f
automodelism	n
ergot	n
ergol	m
sacralitate	f
mămoşenie	f
concologie	f
falangizare	f
verso	n
psi	m
sinecliză	f
pudibonderie	f
îngerea	f
gastrologie	f
teamă	f
suprafiresc	n
franciu	n
benzoe	f
şput	n
auzit	n
abietin	n
yterit	n
xantism	n
lemnărit	n
gnomonică	f
ortocromatism	n
pirogeneză	f
tăiţei	m
tricofiton	n
limfografie	f
bessi	m
gramatistică	f
emanaţionism	n
perisistolă	f
cronogeneză	f
plămădire	f
dezinteres	n
lerpenea	f
centruire	f
titrimetrie	f
intercorelaţie	f
ebenisterie	f
procesualitate	f
discriminaţie	f
numerabilitate	f
endocrinoterapie	f
profesionalitate	f
ştampilografie	f
fotoemisiune	f
epistemologie	f
cubitus	n
histerologie	f
jasp	n
filioque	n
mătcălău	m
dezaminare	f
izopolimorfism	n
sovietizare	f
pâslă	f
punctualism	n
cloncănit	n
pretabilitate	f
ghilimele	f
citologie	f
încondeiat	n
cubism	n
bradicardie	f
anaclorhidrie	f
aeromodelism	n
nautică	f
eternizare	f
singleton	n
latinitate	f
homomorfism	n
picare	f
povestit	n
mitel	n
zigomorfie	f
teatralitate	f
asiduitate	f
cârcă	f
scapăt	n
fotoelasticimetrie	f
ninja	m
misionarism	n
înfricoşare	f
coregrafie	f
antimonit	n
antimoniu	n
coada-vacii	f
kantism	n
ridiculitate	f
nautiloide	n
dulgherit	n
clormetan	n
politicale	f
tatuare	f
sanogeneză	f
asceză	f
băbească	f
tetraciclină	f
tomnat	n
cuzism	n
animalitate	f
pantofagie	f
sentimentalitate	f
ciocolatină	f
greu	n
cloramfenicol	n
capucino	n
microfitologie	f
grej	m
remisibilitate	f
ebrietate	f
întremare	f
tradiţionalism	n
olandeză	f
risorgimento	n
brânca-ursului	f
cosmetologie	f
spongiologie	f
colurie	f
vicepreşedinţie	f
leucit	n
paleografie	f
prelarg	n
ofidiofobie	f
floarea-doamnei	f
cotidianitate	f
literaritate	f
aeroelectronică	f
sulfatizare	f
contemplativism	n
actinometrie	f
patriotism	n
şarpie	f
eritropatie	f
fenomenologie	f
aerotermodinamică	f
petrogeneză	f
filmologie	f
permeanţă	f
paraacetaldehidă	f
patoalimentaţie	f
bacilemie	f
saponit	n
termoplastic	n
glăzuire	f
intercondiţionare	f
spasmofilie	f
decalog	n
germen	m
uguit	n
pupezele	f
protos	m
pneumatică	f
hidatidologie	f
bazedovism	n
respirabilitate	f
cumnăţie	f
mordent	m
ştirba-baba-cloanţa	f
ptialină	f
păţit	n
polifagie	f
bilocaţie	f
amonoliză	f
litotritie	f
afectuozitate	f
sabur	n
proteroginie	f
simţimântalism	n
bocănit	n
neocriticism	n
psihochirurgie	f
cloropenie	f
cistalgie	f
biotipologie	f
aleatorism	n
paralele	f
exponometrie	f
mecanicism	n
inframicrobiologie	f
cerşetorime	f
nazificare	f
hodofobie	f
rahis	n
hospitalism	n
heliometrologie	f
erinofilie	f
radicalism	n
inadmisibilitate	f
zooeconomie	f
patopsihologie	f
sunătoare	f
barba-ursului	f
opistotonus	n
chinestezie	f
neologizare	f
simbologie	f
sociabilitate	f
frullato	n
pocoi	m
bălăngănit	n
filaria	f
sursologie	f
preparative	f
fărâmiţat	n
supuşime	f
termobiologie	f
piroxil	m
coneţ	n
senzaţionalism	n
arici-de-mare	m
analcid	n
elenism	n
zaharină	f
patriarhat	n
sfârcâit	n
criţă	f
antitalent	m
orbie	f
ritualism	n
anarhizare	f
simpatină	f
arbitrarietate	f
psihobiologie	f
nausea	f
tranzistorizare	f
coxalgie	f
helveţi	m
săruri	f
dezomogenizare	f
demologie	f
fragilitate	f
talaş	n
sumeriană	f
molalitate	f
corologie	f
mendre	f
acvaforte	??
micetogeneză	f
caolin	n
meteorobiologie	f
jensinism	n
relotex	n
inautenticitate	f
duplicitate	f
lipit	n
lavabilitate	f
cumpăt	n
fanere	n
egofonie	f
chianti	n
edelvais	n
păpuşare	f
links	n
fiziopatologie	f
peticit	n
spilitizare	f
stropit	n
porc-ghimpos	m
nard	m
obiectitate	f
fart	n
pedagogism	n
hărhălaie	f
amovibilitate	f
decuprare	f
popaz	m
enciclopedism	n
dispensarizare	f
neokantianism	n
aneuroză	f
doruţ	n
ţincvais	n
nomenclaturism	n
cuşcuş	n
factoriale	f
bâzâit	n
recombinant	n
auzibilitate	f
lecitină	f
citrin	n
truficultură	f
crapod	n
clăit	n
aerotehnică	f
calit	n
arabistică	f
slugărime	f
trinitrofenol	m
irenologie	f
tătară	f
pirobalistică	f
afanit	n
praxis	n
elaţie	f
spatang	n
atebrină	f
nefelion	n
arteriografie	f
britani	m
sor-cu-frate	m
opoterapie	f
tiouree	f
prezbiterianism	n
iarbă-creaţă	f
divulsiune	f
ilogism	n
halaj	n
documentologie	f
morfopatologie	f
leu-de-mare	m
astacicultură	f
scutur	n
centurionat	n
desolemnizare	f
pologit	n
neoclasicism	n
peniafobie	f
tutorat	n
harpaxofobie	f
indiferenţă	f
hidragog	n
antiimperialism	n
varia	n
mistral	n
algiditate	f
promoroacă	f
gregarism	n
fitopatologie	f
turta-vacii	f
norit	n
nimbostratus	m
ciprinicultură	f
ruberoid	n
arhitravee	f
anarhosindicalism	n
antroponosologie	f
sererat	n
gheboşat	n
direse	n
geodinamică	f
bilateralism	n
filoneism	n
anarhism	n
hietografie	f
taumaturgie	f
patagiu	n
harachiri	n
cocainomanie	f
hiperactivitate	f
vinicultură	f
oştime	f
pătrunjel-de-câmp	m
donchihotism	n
cloroanemie	f
ihtiotomie	f
blanquism	n
sociaţie	f
gerontism	n
autism	n
zvâcnit	n
iacobinism	n
intelectronică	f
lacerare	f
prairial	m
măritat	n
inimoşie	f
salce	f
recântărire	f
proudhonism	n
tămâiţă-de-câmp	f
ampolozitate	f
hematit	n
citarea	f
trofologie	f
computaţie	f
anemotropism	n
hispanistică	f
arahnologie	f
canter	n
dănţuit	n
brodnici	m
tăbăcit	n
nonbeligeranţă	f
rastru	n
cafea-filtru	f
acupresură	f
platfus	n
salificare	f
cocos	m
pragmatism	n
gigantomanie	f
celofan	n
etnobotanică	f
mânat	n
sare-garduri	m
yterbit	n
hauterivian	n
gatofilie	f
sideroterapie	f
hanâmă	f
fitopaleontologie	f
ratrapare	f
silabism	n
dupăit	n
gibozitate	f
naică	f
voinicit	n
ciompi	m
copoclefilie	f
ortopedagogie	f
cetaceum	n
selenotropism	n
nemţească	f
illium	n
fonetică	f
naftalină	f
comprehensibilitate	f
pentalogie	f
biblioclastie	f
dinamometamorfism	n
bizotare	f
kantianism	n
biodermă	f
îmbrăcare	f
bioelectricitate	f
maleabilitate	f
emotivitate	f
bustrofedon	n
vermis	n
lecitinază	f
abstractism	n
siderism	n
zoocultură	f
antifetişism	n
subzistenţă	f
demonstrabilitate	f
heliotropism	n
incoativ	n
sărat	n
ytrit	n
radiolarit	n
borod	n
alcoolometrie	f
pietate	f
bisexualitate	f
silenţiozitate	f
linografie	f
duraluminiu	n
continentalitate	f
carbonificare	f
citatomanie	f
ubac	n
contex	n
poligamie	f
auxonomie	f
elastină	f
oxigenoterapie	f
precambrian	n
plenilocvenţă	f
captivitate	f
complexare	f
încârligare	f
tenesme	n
filantropie	f
mătreaţă-de-arbori	f
durut	n
anil	n
tâmpire	f
belotă	f
vibronetezire	f
calvinizare	f
sorbită	f
distar	n
piezoelectricitate	f
răpăit	n
disconfort	n
protoginie	f
evaporit	n
răsputiţă	f
incredulitate	f
fâlfâit	n
adamantină	f
erinii	f
monadologie	f
cirus	m
yohimban	n
chimism	n
zapt	n
coroniu	n
pintenul-secarei	m
cornac	m
colibri	m
apifitoterapie	f
plutomanie	f
cirtometrie	f
dorobănţime	f
înăcreală	f
cartomanţie	f
dâcă	f
fotocolografie	f
ufologie	f
ipecacuana	f
floroglucină	f
pavlovism	n
afaziologie	f
austeritate	f
univocitate	f
troficitate	f
permian	n
fenacetină	f
furat	n
furan	m
sinofobie	f
amfotonie	f
pinaclu	n
devoţiune	f
siloxid	m
oidium	n
pavat	n
pruniş	n
ultrafan	n
tină	f
saturn	n
bruiere	f
hipocalcie	f
croază	f
globalism	n
cromoscopie	f
seismicitate	f
seismometrie	f
protargol	n
eidetism	n
lovele	f
gestică	f
peşte-ferăstrău	m
trialog	n
butonare	f
reînviere	f
boacă	f
cimbru	m
fonie	f
albineală	f
cimbri	m
servit	n
catamneză	f
arahnofobie	f
carmin	n
captativitate	f
tarsită	f
reducţiune	f
plener	n
reflexografie	f
molişoare	f
gemelitate	f
electrooptică	f
arhipăstorie	f
pleocroism	n
intranzitivitate	f
julep	n
gomaj	n
paleogeografie	f
fumuri	n
lehamite	f
uraniu	n
plinătate	f
rapiţă	f
şişcă	f
vulnerare	f
pentazol	n
epidot	n
uzucapiune	f
bronhofonie	f
ajungere	f
somatizare	f
amidopirină	f
oxitonie	f
actinolit	n
pseudologie	f
palatolalie	f
bengali	m
podopunctură	f
enterografie	f
chistectomie	f
eluviere	f
zăcăşie	f
uzinare	f
imoderaţie	f
recesivitate	f
ascuţit	n
dacron	n
trei-fraţi	m
pufuleţi	m
timbrotecă	f
afion	n
uperizare	f
heterocarde	n
etologie	f
diastrofism	n
endoecie	f
politropism	n
neojunimism	n
termodinamică	f
fenotip	n
cumulostratus	m
cuplu-maestru	n
germanistică	f
papalitate	f
ponofobie	f
antidetonanţă	f
aseptizare	f
cuprit	m
augustinism	n
olandină	f
etnologie	f
euhemerism	n
existenţialitate	f
ruz	n
topometrie	f
casiopeiu	n
dimetilformamidă	f
entomofilie	f
lehăit	n
etiomorfoză	f
nebuliu	n
belicism	n
marginalitate	f
filologie	f
texoprint	n
manganometrie	f
embriogenie	f
supral	n
agrologie	f
solidarism	n
şamanism	n
cochinchină	f
idioecologie	f
nous	n
tarapangele	f
moralism	n
salmiac	n
pluripartism	n
frunzărime	f
etnogeografie	f
detectabilitate	f
pedogeneză	f
kieselgur	n
disimilitudine	f
surdomutitate	f
nuclează	f
biosferă	f
oligofrenopedagogie	f
solificare	f
kovar	n
triumfare	f
fierărit	n
dacită	f
galeropie	f
psefologie	f
acromatopsii	f
inactivism	n
aritenoid	n
melaminare	f
fiere	f
transpirare	f
solodizare	f
schinduf	m
fiert	n
fracţionism	n
izostazie	f
kamikaze	m
ganglioplegic	n
planctonologie	f
austru	m
pripă	f
lignofoliu	n
difterovariolă	f
nauplius	m
cuadrifonie	f
blastografie	f
ciclită	f
submersibilitate	f
stabulaţie	f
baileu	n
porto-franco	n
beta	m
dealcoolizare	f
miluţă	f
înturnare	f
crâmpoşie	f
sigma	m
neterminat	n
mistelă	f
nicotinizare	f
exitus	n
ignorantism	n
heliu	n
sofrologie	f
ofidiofilie	f
ectrodactilie	f
milesian	n
fâstâceală	f
infinitism	n
vorbit	n
complianţă	f
înhămat	n
coregrafiere	f
calao	m
impetigo	n
cvietism	n
august	m
spaţialitate	f
carnabat	n
pudicitate	f
radiofonie	f
ergologie	f
odontopatie	f
sorabistică	f
corectopie	f
colbăraie	f
galofobie	f
normalitate	f
radiobiologie	f
cebocefalie	f
impedanţă	f
frenaj	m
tardivitate	f
concizie	f
zoroastrism	n
ginecocraţie	f
decapotabilitate	f
coca	m
periglaciar	n
camfor	n
spiroscopie	f
somnolaritate	f
volapuk	n
lăut	n
patriciat	n
tomnatic	n
catalografie	f
cataforeză	f
asfaltizare	f
garnierit	n
inconştienţă	f
nandu	m
psaltichie	f
egumenie	f
geopatologie	f
lacrimogenitate	f
halit	n
blastom	n
electroterapie	f
nazism	n
şvaiţer	n
fierea-pamântului	f
caramelizare	f
quidam	n
ortopedie	f
istroromână	f
tocmagi	m
aparţinere	f
biocenologie	f
eredobiologie	f
omasum	n
mamă-soacră	f
policlorură	f
agora	f
vascularizaţie	f
ucronie	f
imposibilitate	f
audiografie	f
comutabilitate	f
edam	n
pipat	n
netemeinicie	f
metapsihologie	f
catifelare	f
împoporare	f
licopodiu	n
genetică	f
lues	n
tiocol	m
diascopie	f
gillbox	n
tanana	f
viplă	f
funcţionărime	f
palilalie	f
laie	f
fluoresceină	f
electrostatică	f
zimogeneză	f
mumificaţie	f
ravitaliere	f
dinitrofenol	m
farfurărie	f
grafoscopie	f
anexionism	n
malarie	f
înduioşare	f
zoocid	n
ecolalie	f
stupor	n
paleoetnologie	f
organopatie	f
nobeliu	n
taxocenologie	f
laminectomie	f
decorativism	n
creativitate	f
antiparlamentarism	n
inteligibilitate	f
jalapă	f
biocrom	n
antisepsie	f
indestructibilitate	f
tragism	n
verbigeraţie	f
bucolism	n
heliodor	n
creolină	f
reacumulare	f
minimum	n
similipiatră	f
înnegrire	f
dirijat	n
peching	n
rotunjoare	f
acta	n
limnologie	f
anghelică	f
demucilaginare	f
ofiotoxină	f
optoelectronică	f
metaforism	n
înviere	f
bradt	n
plutonism	n
energol	n
fardaj	n
sclerometrie	f
ultrapas	n
mucea	m
răsculare	f
lăţiş	n
părul-Maicii-Domnului	m
micro	n
zorire	f
muzicalitate	f
verslibrism	n
cromoalgrafie	f
nitrofoska	n
scroafă-de-baltă	f
acvaherboză	f
arborizaţie	f
kamala	m
discondroplazie	f
afeliu	n
tricotin	n
perfecţionism	n
chimiotropism	n
asindet	n
acceptanţă	f
confinii	n
senarmontit	n
tonificare	f
iertat	n
cutreier	n
cameralism	n
supraordonare	f
munte-de-pietate	m
javelizare	f
inocuitate	f
bot-gros	m
agalactie	f
logoree	f
coralitate	f
personalism	n
lantan	n
fluture-alb	m
polonă	f
paludoterapie	f
alegorism	n
gimnastică	f
chimen	m
metalurgie	f
chemosorbţie	f
preclasicism	n
betacism	n
lichenologie	f
vivacitate	f
liliac-de-munte	m
alchil	m
pârlit	n
alabandină	f
strioscopie	f
senzitivism	n
celibat	n
fotoenergetică	f
retardare	f
răsfug	n
postumitate	f
gerontoecologie	f
temeinicie	f
craniopatie	f
glaciarizaţie	f
stereografie	f
ornitomanţie	f
cetonurie	f
rână	f
speologie	f
litiu	n
kodak	n
sclavaj	n
paramagnetism	n
propan	m
pirognostie	f
nestoterapie	f
etilism	n
endometru	n
nesimţire	f
multilateralitate	f
somptuozitate	f
prăjit	n
craniografie	f
detalonare	f
zeciuri	n
benzoilare	f
analizabilitate	f
iele	f
decomplexare	f
micrometrie	f
arcosolium	n
înecare	f
colosalitate	f
umblat	n
malariologie	f
pantomografie	f
celtistică	f
ziulică	f
taheografie	f
topologie	f
imputrescibilitate	f
digitalism	n
condroniu	m
autoeducaţie	f
paleontografie	f
eremitism	n
haraiman	n
ciuntire	f
calicie	f
etocraţie	f
mitomanie	f
geonemie	f
servaj	n
agronomie	f
sismoterapie	f
hipotehnie	f
pelvilogie	f
treierat	n
chimioterapie	f
morfognozie	f
decrescendo	n
telepublicitate	f
muscă-albastră	f
cauzalism	n
strei	n
coalescenţă	f
militărie	f
forabilitate	f
gătire	f
verticalism	n
neastâmpăr	n
gerontologie	f
hiperlatinism	n
impozabilitate	f
tiocarbamidă	f
iconolatrie	f
sindicalism	n
îndrăgire	f
franceză	f
scopocrom	n
socotit	n
frotaj	n
nepreget	n
fenilbutazonă	f
cânepă	f
galvanotehnică	f
nesfârşire	f
stilism	n
hidrografie	f
caligrafie	f
crobizi	m
rhyton	n
discromatopsie	f
principialitate	f
gerovital	n
dum-dum	n
operaţionalizare	f
antropopatism	n
siderurgie	f
transponder	n
corectitudine	f
argirism	n
munculiţă	f
fereală	f
causticitate	f
linters	n
pântecăraie	f
mahometism	n
comati	m
niobit	n
crisopraz	n
vizualitate	f
pedogamie	f
acronie	f
droaie	f
combustibilitate	f
geogenie	f
abducere	f
magnalin	n
paralexie	f
chinonă	f
largheţe	f
dibenzoil	n
organum	n
radiculită	f
dixie	n
tarara	f
mâncărici	n
heautoscopie	f
anticabraj	n
elastanţă	f
cuţulache	m
mediocrizare	f
nimereală	f
banderolare	f
metiloranj	n
şoşele	f
tiranizare	f
ihtiometrie	f
amaltheus	n
carbonitrurare	f
miazăzi	f
autocromie	f
coronişte	f
oportunism	n
singaleză	f
xilomanţie	f
contextualitate	f
mehari	m
tribali	m
praxiologie	f
jerpelire	f
foame	f
neoliberalism	n
şoferie	f
farmacologie	f
maharani	f
incorporaţie	f
abolla	f
verdeaţa-zidurilor	f
disistolie	f
măturele	f
psiholingvistică	f
cardiotomie	f
quadrivium	n
electroacustică	f
rapakiwi	n
tiroidism	m
remuu	n
etnoiatrie	f
mutacism	n
dezoxicorticosteron	m
labă-de-iepure	f
pseudococaină	f
nictemer	n
vates	m
difuzivitate	f
astigmatism	n
lele	f
vigilitate	f
sincorologie	f
tutorare	f
perinatalitate	f
daiaci	m
rubato	n
misologie	f
neuropsihologie	f
parvenire	f
decorsetare	f
sublim	n
meteoritică	f
ecogenetică	f
enervaţie	f
cardium	n
neotectonică	f
câră	f
merinos	m
africanism	n
tortonian	n
plimbat	n
taxidărie	f
alezie	f
frusteţe	f
tombolo	n
africanitate	f
clorurare	f
actinoterapie	f
dărăcitură	f
suberină	f
icnografie	f
ştrecuit	n
autoagresiune	f
cinopedie	f
sturluibare	f
auto	n
hemerologie	f
bonzai	m
chelălăit	n
salacitate	f
lassalleanism	n
tai-mălaiul	n
agriologie	f
tulburel	n
epizeuxis	n
apărie	f
flutură-vânt	m
exploatabilitate	f
cernit	n
medievalism	n
jacmar	n
hominizare	f
îmburghezire	f
ţâţa-fiului	f
citoscopie	f
preadolescenţă	f
consumerism	n
scherzo	n
purism	n
cazeinogen	n
einsteiniu	n
dăscălime	f
preavertizare	f
apolitism	n
flip	n
würm	n
cheiromegalie	f
antifricţiune	f
iliră	f
rindeluit	n
aerlift	n
neolatinism	n
disproteinemie	f
silumin	n
premenopauză	f
etionastie	f
litargă	f
perpetuitate	f
arondare	f
astereognozie	f
alcoolizare	f
optometrie	f
platiniridiu	n
invar	n
kripton	n
ciocnit	n
aristocratism	n
amoralitate	f
exequatur	n
lucernă	f
călugărie	f
cheiloplastie	f
promeţiu	n
aleuronat	n
mecanografie	f
ruber	n
ambosare	f
liberti	n
burbion	n
vitiligo	n
broasca-apei	f
mesapi	m
împletit	n
biometrie	f
ciclohexan	m
relatinizare	f
taim	n
supratonică	f
odorimetrie	f
oxidabilitate	f
electrostimulare	f
babezia	f
consangvinizare	f
glaciodislocaţie	f
heterozis	n
calende	f
nocivitate	f
finalism	n
subconştient	n
iscurie	f
hortiviticultură	f
copai	n
copal	n
cantus	n
amatorism	n
artificialitate	f
aerocolie	f
unt	n
dedină	f
zooigienă	f
sparteină	f
tranşare	f
feminitate	f
alocorie	f
mac-cornut	m
ales	n
alem	n
astralită	n
lichidatorism	n
argilit	n
alfatron	n
lăptic	n
pavor	n
biotransformare	f
insesizabilitate	f
încurcală	f
tontoroi	n
hiperglobulie	f
inox	n
filotehnie	f
rădăcinoase	f
getinax	n
coada-mâţei-de-baltă	f
sculptat	n
baragnozie	f
jăratic	n
mitificare	f
gamacism	n
aplanare	f
prizonierat	n
tighelit	n
ceremonialism	n
zitum	n
vopsit	n
selenologie	f
azeotropie	f
umanizare	f
ouat	n
adicţie	f
pembe	f
acmee	f
linoxină	f
cifraj	n
jurimetrie	f
supliciere	f
telecinema	n
germene	m
mărar	m
cambiu	n
tularemie	f
placiditate	f
electropatologie	f
lombosciatică	f
sinechie	f
diacustică	f
electrocardiografie	f
paşoptism	n
grafomanţie	f
somatologie	f
deontică	f
cosmobiologie	f
egoism	n
camohas	n
jargonafazie	f
absintomanie	f
sansevieria	f
clinoterapie	f
încifrare	f
blefaroptoză	f
hevea	f
zirconiu	n
zbânţ	n
prostălău	m
blimp	n
convertină	f
hemianestezie	f
margarit	n
disfagie	f
fibromatoză	f
radiosensibilitate	f
ciclopropan	m
definitivat	n
mepacrină	f
pantoclastie	f
potabilitate	f
huşte	f
prezbitism	n
senzorialism	n
fidelitate	f
camerling	m
berneveci	m
saţietate	f
blajinătate	f
cosmogonie	f
cetan	n
policroism	n
ytrocerit	n
menilit	n
vodă	m
hăci	n
dada	n
dendrografie	f
geoacustică	f
aerodinamicitate	f
gradel	n
mamă-mare	f
simbolism	n
pantoful-doamnei	m
colchicină	f
ampelografie	f
nacru	n
osmiridiu	n
negru-moale	m
astringenţă	f
vervă	f
modificabilitate	f
microeconomie	f
disipaţie	f
paroxitonie	f
atefobie	f
centurare	f
semiîntuneric	n
meteorotropism	n
galactografie	f
convalescenţă	f
xenon	n
constructivism	n
pulpitum	n
zapateado	n
pliscul-cocorului	n
anorexie	f
cazacincă	f
tireotoxicoză	f
parizer	n
tinerime	f
vâscozitate	f
devotament	n
pectază	f
corectazie	f
izometropie	f
amfigonie	f
algebrologică	f
desfăt	n
nescafe	n
cobbler	n
antroponimie	f
liberalism	n
sociopsihiatrie	f
încălărare	f
epigrafie	f
mischet	n
ocazionalism	n
perhidrol	n
diapauză	f
otrăţelul-bălţilor	m
chinovar	n
aplomb	n
chibzuinţă	f
cantilever	n
astrognozie	f
directivitate	f
inginerie	f
luteranism	n
trend	n
acvacultură	f
colir	n
şapou	n
termostatare	f
agnosticism	n
zoogeografie	f
dulcinee	f
corbet	n
lăudăroşie	f
tutelare	f
termostabilitate	f
eleatism	n
etnotanatologie	f
păşunat	n
glosematică	f
cărpănoşie	f
detimbrare	f
brianţă	f
birocratizare	f
diurnal	n
exteritorialitate	f
zecică	f
înrădăcinare	f
sociografie	f
trombocitoză	f
piscuire	f
dalmată	f
detritus	n
caldarium	n
dezuleiere	f
fitobiologie	f
făcut	n
hemobiologie	f
îndobitocire	f
megalitism	n
plurivocitate	f
endomorfism	n
cvasitotalitate	f
aeroelasticitate	f
aprobabilitate	f
grimon	n
stereotaxie	f
oficializare	f
împopoţonare	f
leucocidină	f
balneoterapie	f
nucleonică	f
tubiflore	f
monosemantism	n
hegelianism	n
dacit	n
survolare	f
digitalină	f
trăscău	n
stomalgie	f
poleit	n
lacrimă-Christi	n
preciziuni	f
poama-câinelui	f
marmatit	n
gestoză	f
dermopunctură	f
semnat	n
complotism	n
mixedem	n
putrescibilitate	f
fibrinogen	n
uşa-raiului	f
instantaneitate	f
hidrologie	f
salvatoare	f
girofrecvenţă	f
metabolism	n
organicism	n
ustilaginale	f
pozitivism	n
serios	n
înhămare	f
macedoneană	f
mesohippus	m
sagitaria	f
epsilon	m
relativitate	f
teromorfe	f
dezalcoolizare	f
frag-de-câmp	m
analgezie	f
maraging	n
devize	n
prour	n
sagna-calului	f
ciclopentadienă	f
solmizaţie	f
nadir	n
balmoş	n
ferestruire	f
gestaltism	n
antipatriotism	n
rolan	n
agrimensură	f
umanism	n
mixtare	f
monofoto	n
cromofotogravură	f
carstologie	f
presaj	n
deparat	n
îngrăşătoare	f
presat	n
zonalitate	f
omeoză	f
period	n
burtăverde	m
pelagrozină	f
alelogamie	f
rabană	f
poantilism	n
ideaţie	f
gnoseologie	f
descălecătoare	f
răşinoase	f
hibridogamie	f
manila	f
cerşetorit	n
kelvin	m
iluminat	n
cinerit	n
gemaţie	f
electromagnetism	n
apirexie	f
muscă-mare	f
teatralism	n
grasă	f
şluf	n
simţibilitate	f
fotoceramică	f
misticizare	f
zincat	m
cambrian	n
feminism	n
plictis	n
coclire	f
cosmolatrie	f
bâlbâilă	m
ecogeneză	f
histerezis	n
paleomagnetism	n
neurologie	f
boieresc	n
protocronie	f
geocarpie	f
moravuri	n
atematism	n
interlock	n
iranologie	f
prozodie	f
bente	f
masticare	f
bioeconomie	f
porter	n
iarbă-mare	f
mâzgă	f
nuntit	n
lienografie	f
desmotropie	f
şindrilit	n
recirculaţie	f
eterie	f
cazeificare	f
salvamont	n
slovenă	f
şnuruit	n
neosalvarsan	n
trivium	n
tămbălău	n
diotron	n
trucare	f
leşie	f
incoruptibilitate	f
acantologie	f
rezistin	n
floculare	f
cretaceu	n
şmirghel	n
iperige	f
zoomorfie	f
la	m
complementaţie	f
cordialitate	f
decomandare	f
grâuleţ	m
higrologie	f
metastabilitate	f
dietoterapie	f
combativitate	f
litostrot	n
parosmie	f
cârciumărit	n
dialingvistică	f
progeneză	f
lisp	n
budism	n
patologie	f
clincher	n
poală-albă	f
dezumflat	n
sud	n
pomină	f
pelobiont	n
cosmiatrie	f
cumpărare	f
comodat	n
neştire	f
smithsonit	n
instituţionalism	n
dimerizare	f
înăbuşire	f
băbăluc	m
tramping	n
nicotinamidă	f
cosmicizare	f
sorditate	f
astrometeorologie	f
valanginian	n
radiocalciu	n
flax	n
nonius	m
potcovit	n
derobare	f
dispnee	f
iconicitate	f
pielărit	n
solitarism	n
onomanţie	f
antimălurire	f
susai	m
susan	m
transplantologie	f
neurocibernetică	f
păsărime	f
tripoli	n
antivedetism	n
alumină	f
confesivitate	f
prenadez	n
amonificare	f
varacton	n
metol	m
colpocitologie	f
ceroplastică	f
electronizare	f
imnologie	f
bălăcit	n
ligaturare	f
codinit	n
cleistogamie	f
ideomotricitate	f
soteriologie	f
prometeism	n
condrină	f
alopatie	f
nistagmus	n
diplomanie	f
spermanţet	n
stereotomie	f
normativism	n
adogmatism	n
lemuri	m
mangafache	m
entalpie	f
lamelicorni	n
lamelicorne	n
cistometrie	f
durare	f
nobleţe	f
racemic	n
existenţialism	n
poliembrionie	f
onestitate	f
compacitate	f
hialografie	f
metalografie	f
paleozoologie	f
alelogeneză	f
istoveală	f
adinamie	f
frăgezime	f
simplism	n
mătasea-bradului	f
Alteţă	f
negativizare	f
limfatism	n
apartinitate	f
izometrie	f
hidrocorie	f
cerargirit	n
catodoluminescenţă	f
tăricioare	f
luteină	f
demonstrativitate	f
barter	n
termicitate	f
plantago	m
ortodontologie	f
salivă	f
centralitate	f
ateroscleroză	f
prudenţă	f
anamneză	f
îndârjire	f
catharsis	n
viitorime	f
criminalistică	f
egofilie	f
şalanj	n
citopatologie	f
numulitic	n
cunial	n
jasmin	m
bibi	m
soll	n
eponj	n
detectivism	n
spectroscopie	f
scotocit	n
asistenţă	f
hipersensibil	n
vitrit	n
aristotelism	n
cianogen	n
deaferentare	f
război-fulger	n
melificaţie	f
psihoigienă	f
demos	n
automatică	f
fotoelectricitate	f
glicemie	f
termoelectricitate	f
fosfină	f
yucca	f
patafizică	f
ireproşabilitate	f
telemecanică	f
câştigare	f
obituar	n
eritrism	n
cohlee	f
glosoplegie	f
dubitaţie	f
dezinserţie	f
excitabilitate	f
pita-vacii	f
monogenism	n
meşi	m
catalază	f
pufăit	n
sfârcul-babei	n
aeroterapie	f
digestibilitate	f
emfază	f
psihoterapeutică	f
vinicer	m
cinefilie	f
trifoliene	f
comercialism	n
deburbaj	n
bele-arte	f
parabiont	n
aticism	n
intraductibilitate	f
ocazionalitate	f
acrobatică	f
hrean	m
reabordare	f
vapoterapie	f
sepia	f
posologie	f
tricotat	n
neruşinare	f
primordialitate	f
transluciditate	f
dermografism	n
sibir	n
amoniac	n
glaciologie	f
chietism	n
rouşoară	f
virilizare	f
helancă	f
judo	n
gnosticism	n
haşişism	n
balboa	m
narcisism	n
vanisare	f
folk	n
agroecologie	f
digitron	n
cuestă	f
miazănoapte	f
neîndemânare	f
bulimie	f
pletoră	f
dendrofilie	f
zerdiceaf	m
aţintire	f
neurofilaxie	f
frită	f
duct	n
bărbăţie	f
duco	n
homeoplazie	f
Eminenţă	f
păgânism	n
almandin	n
iarbă-de-mare	f
efeminaţie	f
apogamie	f
ginerică	m
perpetrare	f
solutrean	n
picturalitate	f
gliptogeneză	f
adenotomie	f
ghişet	n
oligofrenologie	f
suetă	f
iatrozofie	f
militarism	n
difeniloxid	m
zăvorâre	f
străromână	f
huruit	n
elenizare	f
paleoslavă	f
pleonast	n
eutanasie	f
diastil	n
fenogenetică	f
dever	n
electrocopie	f
endoestezie	f
incandescenţă	f
hochei	n
hipoderm	n
plugărit	n
barotropism	n
telerecording	n
plugărie	f
gelivaţie	f
poligenism	n
honuit	n
gângurit	n
iscusire	f
nepăsare	f
paneton	n
undit	n
deburare	f
esteziologie	f
hasidism	n
garantism	n
fibroină	f
eupnee	f
artefice	m
servitorime	f
acvaristică	f
premilitărie	f
hegemonism	n
varianţă	f
mugurire	f
ecografie	f
ritualitate	f
nopal	m
recapitulaţie	f
apiolină	f
grecizare	f
muabilitate	f
pipi	n
calul-dracului	m
crisografie	f
viviparitate	f
larmăt	n
cianină	f
spectrofotometrie	f
făinare	f
beotism	n
paternalism	n
trinitroceluloză	f
partiu	n
nedormire	f
pârguit	n
paracetamol	n
sciziparitate	f
xilit	n
antigravitaţie	f
bubuit	n
cello	n
ecvinism	n
melomanie	f
job	n
regalism	n
keramit	n
vişiniu	n
acurateţe	f
curarizare	f
operatorie	f
astrogeologie	f
detubare	f
emoţionare	f
înmănunchere	f
cucută-de-pădure	f
insularism	n
gordin	m
tineret	n
vargă-de-aur	f
progresism	n
cefere	n
memorabilitate	f
publicitate	f
amorfism	n
benedictină	f
îngropat	n
documentografie	f
rotary	n
aerofilatelie	f
zeflemism	n
palpabilitate	f
insulină	f
săpunărit	n
jucat	n
marcomani	m
indemontabilitate	f
agheasmă	f
Maiestate	f
monoandrie	f
anencefalie	f
parachor	n
gâlgâit	n
defetism	n
nord-est	n
politopie	f
gigantism	n
craul	n
insensibilizare	f
futurism	n
ralantizare	f
păsăret	n
agaricacee	f
cvadruplex	n
perisferă	f
ortologie	f
pudoare	f
polarimetrie	f
pescărit	n
contondenţă	f
divizionism	n
provensală	f
mercantilism	n
molcomeală	f
realgar	n
carborundum	n
acromegalie	f
mană-de-ape	f
laboriozitate	f
aplit	n
jugănire	f
cvadratură	f
biocenoză	f
tenorino	m
nitragin	n
epizootologie	f
taboriţi	m
barochism	n
apologetică	f
paraglobină	f
aurină	f
morfologie	f
ţiitori	f
filat	n
sangvinitate	f
ablactare	f
tutoraj	n
credibilitate	f
sâsâit	n
operativitate	f
corhart	n
împrumutare	f
liguri	m
împăienjenire	f
zombianism	n
năucie	f
buşi	m
obscurantism	n
militare	f
sclipit	n
doritoare	f
lamaism	n
pedonosologie	f
insaţietate	f
decorativitate	f
odorologie	f
ecostabilitate	f
haretism	n
duecento	n
delicvescenţă	f
japonism	n
macrografie	f
pomologie	f
crengărie	f
fanerit	n
încărcat	n
neîndemână	f
recalculaţie	f
quipu	n
grotesc	n
lirică	f
bonapartism	n
înţepenire	f
lizol	n
iobăgie	f
pandurime	f
dendroclimatologie	f
cântărit	n
vedism	n
brontologie	f
litispendenţă	f
olimpianism	n
panasiatism	n
gastrofiloză	f
abrastol	m
babirusa	f
măruntaie	n
indicanemie	f
silvinit	n
şoimărit	n
orbilă	m
sahelian	n
infraroşu	n
nunească	f
uranolatrie	f
cinsteţ	m
interscapulum	n
molia-albinelor	f
paraglobulină	f
contralto	n
liricizare	f
listel	n
neofobie	f
metageneză	f
programatism	n
terpin	n
recto	n
imersiune	f
ştevie-de-munte	f
riboză	f
teofilină	f
scolastică	f
cotitate	f
echipolenţă	f
dactilografie	f
legumen	n
etnocentrism	n
tiflomegalie	f
adactilie	f
hipsofobie	f
opunţia	f
antroposomatologie	f
microprint	n
piroluzit	n
axiomatică	f
transcalculare	f
apicultură	f
instrumentalism	n
bolet	m
ritmică	f
trass	n
hematodermie	f
telecinemateca	f
psihofiziologie	f
bechi	n
ruptoare	f
pirotină	f
galimatias	n
auzire	f
sofistică	f
confidenţialitate	f
timus	n
hidrofitologie	f
carbon	n
pelvimetrie	f
federalism	n
pălăvrăgit	n
alpinism	n
staţionarism	n
minimalitate	f
schinduc	m
somatognozie	f
alămire	f
geomorfologie	f
atonie	f
androfobie	f
potrivă	f
homeomorfism	n
edibilitate	f
etnonimie	f
malapropism	n
palmă-cu-spini	f
ginopare	f
patrimonializare	f
comprehensiune	f
tribadism	n
zahăr	n
fermentescibilitate	f
humologie	f
aikido	n
odagaci	m
zdrăngănit	n
storno	n
neretroactivitate	f
aluzivitate	f
anabolism	n
formaj	n
bolohoveni	m
prosperitate	f
heteroforie	f
iarbă-de-Sudan	f
martensită	f
clorometrie	f
antropopsihologie	f
potamobiologie	f
înfulecare	f
bimetalism	n
pratologie	f
afuzali	m
talamus	n
parţialitate	f
urcat	n
avocatură	f
nestatornicie	f
spring	n
melanit	n
ortoclaz	n
condrologie	f
sânziana-voinicească	f
hexametafosfat	m
cădenie	f
marxism-leninism	n
imambaialdî	n
inchiziţie	f
conspirativitate	f
haşiş	n
rubricariu	n
slavitate	f
algezimetrie	f
morganism	n
simbolistică	f
picrit	m
hidrargirism	n
textolit	n
stereotipism	n
secundaritate	f
fitofiziologie	f
zavescă	f
eminescianism	n
incipit	n
ergotropie	f
pomicultură	f
maţe-pestriţe	m
camuflet	n
salbă-râioasă	f
demografie	f
catatonie	f
papagal-de-brazi	m
urbanism	n
fovism	n
hagiologie	f
antirevizionism	n
absintism	n
sorţi	m
conflictualitate	f
cianit	n
batimetrie	f
tebaism	n
dinamologie	f
polisindeton	n
tribologie	f
efendi	m
apogenie	f
hidrogeologie	f
obsecviozitate	f
dactilomanţie	f
neomorfism	n
fandango	m
precocitate	f
microdur	n
diazotare	f
stiroflex	n
protobiologie	f
briologie	f
pedocentrism	n
parodont	n
xenologie	f
molfăit	n
carnalit	n
galeofilie	f
pasabilitate	f
ţârişoară	f
plutărit	n
preoţie	f
olfactronică	f
normativitate	f
distributivitate	f
colligatum	n
polder	n
uranometrie	f
liber-schimbism	n
vaginism	n
stibină	f
argentan	n
cavernoscopie	f
cefalină	f
alegreţe	f
enometrie	f
tabla-başa	m
fotoperiodism	n
tiflologie	f
rădăciniş	n
electuar	n
cimerieni	m
Excelenţă	f
mei-pădureţ	m
şovinism	n
erotomanie	f
cinci-degete	n
suit	n
criomagnetism	n
lipidologie	f
fasolică	f
crudităţi	f
imaterialitate	f
autotracţiune	f
funcţionalitate	f
benzopurpurină	f
mangan	n
tiloză	f
contare	f
miroase	n
berkeliu	n
românie	f
deferenţă	f
borium	n
ristic	n
bade	m
uncropel	n
maraschino	n
pârgă	f
circumnutaţie	f
rudacee	f
declinabilitate	f
animalculism	n
pirop	n
factotum	m
heliopatie	f
iraţionalism	n
neutralism	n
kakemono	n
domiciliere	f
paleozoic	n
histogenă	f
codeinomanie	f
geotehnică	f
dixieland	n
sebum	n
eifelian	n
atelectazie	f
aprobativitate	f
duium	n
vitaminoterapie	f
morfonemie	f
seroterapie	f
aragonit	n
cerebralitate	f
buret	n
motociclism	n
riboflavină	f
sportivitate	f
oblativitate	f
caprotină	f
turbidimetrie	f
brom	n
antropometrie	f
ferocitate	f
didacticism	n
edafon	n
imersare	f
chelbe	f
curechi	m
jurasic	n
sialoree	f
eterodoxie	f
materialitate	f
perlit	n
emetropie	f
parşi	m
paremiologie	f
retrocompatibilitate	f
desfăcut	n
acvalang	n
blastoftorie	f
progesteron	n
caşexie	f
acondroplazie	f
ergan	n
uite-popa-nu-e-popa	n
taxon	m
cerapastel	n
vanilism	n
imago	f
calciferol	n
duarhie	f
cornurele	n
daltonism	n
demonolatrie	f
dipsoterapie	f
cationizare	f
francofilie	f
paraaldehidă	f
fucsină	f
înverzire	f
scrofularia	f
amiloidoză	f
az	m
imutabilitate	f
litogeneză	f
vălul-miresei	n
altiport	n
anarţi	m
pitagorism	n
torsionare	f
serenitate	f
rontgendiagnostic	n
antifilistinism	n
decrepitudine	f
purpuriu	n
înfocare	f
androlatrie	f
clorurie	f
îngrăşat	n
favisă	f
convertizare	f
capilaritate	f
izotropie	f
decepţionism	n
găinuţe	f
dramatism	n
antonomaj	n
tăiculean	m
heterozide	f
barremian	n
pasibilitate	f
afectivitate	f
călit	n
canafas	n
mitigaţie	f
anasarcă	f
batarist	n
gonoree	f
patroclinie	f
asaltare	f
piatra-iadului	f
caca	f
oţiozitate	f
cerărit	n
neexecutare	f
mordansare	f
antracit	n
oralitate	f
productibilitate	f
ponţian	n
dactilografiat	n
pirometrie	f
pătrunjelul-câinelui	m
gargarism	n
rediţie	f
biligeneză	f
bâjbâit	n
simplocă	f
tivit	n
teatrologie	f
jupuit	n
tetralină	f
caudillo	m
trogloditism	n
anglicanism	n
pteridologie	f
lasitudine	f
odiu	n
medalistică	f
cumulonimbus	m
râcâit	n
pistol-portbandulă	n
holofrază	f
nouă-ochi	m
diplofază	f
coada-rândunicii	f
ascuns	n
satin	n
şlem	n
brânza-iepurelui	f
gurluit	n
molia-de-stup	f
metamarketing	n
ursuzenie	f
minoian	n
pieptănat	n
baconism	n
tafonomie	f
extrospecţie	f
sionism	n
ciorap-pantaloni	m
scleron	n
predicativizare	f
bizantinologie	f
ciclobal	n
bandoală	f
croşete	f
scleroţi	m
nesocotire	f
reegibilitate	f
lelică	f
nife	n
oncologie	f
boncăluit	n
plac	n
aerogastrie	f
firesc	n
asus	n
vitellus	n
ebenistică	f
monopolism	n
narcolepsie	f
asiriană	f
fâşâit	n
conje	n
freudism	n
mercur	n
colereză	f
mastografie	f
cosmoeconomie	f
deziderabilitate	f
mononucleoză	f
respectabilitate	f
abstractivitate	f
toptan	n
radiometeorologie	f
penurie	f
dilver	n
geologie	f
filarioză	f
flogopit	n
tenebrion	m
dodecafonie	f
fenologie	f
graminologie	f
mormonism	n
agrostologie	f
scame	f
publicistică	f
nanomelie	f
glosopatie	f
sambo	m
biocronologie	f
etnografie	f
urât	n
naturalitate	f
inconstatabilitate	f
neamestec	n
perigalaxie	f
firn	n
plexiglas	n
automobilism	n
bufnit	n
rug-domnesc	m
sinoverb	n
impactare	f
periodonţiu	n
coca-cola	f
eozinofilie	f
tahogramă	f
spânzurat	n
hominieni	m
cristalogeneză	f
galvanoplastic	n
cannel	n
sucilă	m
îndurerare	f
sima	f
disfuncţionalitate	f
măduvă	f
puerperalitate	f
cianhidrizare	f
inevitabilitate	f
necrofagie	f
măjărit	n
hexaclorbenzen	m
probandat	n
sinostoză	f
werfenian	n
anaplazie	f
dezactualizare	f
nebăgate	n
fluieră-vânt	m
mierte-fierte	f
duble	n
paralâc	n
dacnomanie	f
sifiligrafie	f
francmasonerie	f
autotrofie	f
lint	n
inapetenţă	f
gârboveală	f
turgor	n
cristianism	n
tractus	n
lascivitate	f
aplauze	n
spontaneitate	f
ermitizare	f
formalism	n
halieutică	f
lamelirostre	f
aerofobie	f
sfredelul-lemnului	n
coda	f
crucea-voinicului	f
imundicitate	f
piromanie	f
talasogeneză	f
monarhism	n
neocatharsis	n
opritori	f
cartologie	f
jivraj	n
meschinizare	f
batologie	f
aerobiont	n
melanemie	f
neică	m
ortohidrogen	n
exportabilitate	f
fâţâit	n
citit	n
emplecton	n
fiziocratism	n
radioamplificare	f
fonoghid	n
procustianism	n
metionină	f
diageneză	f
du-te-vino	n
glosofobie	f
disgrafie	f
lilialitate	f
fizostigmină	f
romanticitate	f
senă	f
mediumnitate	f
higrometrie	f
metaloceramică	f
ligroină	f
dantistică	f
sfigmografie	f
drămăluire	f
zoofagie	f
odometrie	f
eminescologie	f
papaină	f
ranversare	f
precaria	f
rototrol	n
opiofagie	f
logistică	f
stagnoplancton	n
tastare	f
cascadorism	n
sortat	n
interşanjabilitate	f
cumâs	n
gnotobiotică	f
vuit	n
batofobie	f
parapon	n
jumulit	n
benzidină	f
heteroblast	n
iotă	f
eben	n
emoţionabilitate	f
ioniţi	m
dezmorţire	f
tahimetrie	f
rahianestezie	f
reformism	n
coniferină	f
discografie	f
alpinariu	n
oologie	f
hayon	n
tălpuit	n
benzolism	n
mitocănime	f
latină	f
paştile-cailor	m
criolit	n
pinet	n
cenofobie	f
emotivism	n
impressum	n
fleşcăit	n
impudoare	f
hicsoşi	m
afabulaţie	f
strofantină	f
sonicitate	f
fibrilizare	f
alopecie	f
şpighel	n
iodopsină	f
acroparestezie	f
neagă-rea	f
pertinenţă	f
bazidiomicete	f
decimolet	n
iuft	n
tonare	f
micromecanică	f
fumegărie	f
inutilitate	f
barisferă	f
corticotomie	f
incarbonizare	f
paleobotanică	f
îndopat	n
irimic	n
flabel	n
hipobarism	n
ignifugare	f
debuşonare	f
reîntremare	f
anamorfozare	f
piatră-de-var	f
argentin	n
incombustibilitate	f
argentit	n
melodium	n
mnemotehnică	f
antroponomastică	f
hesperornis	m
proeres	n
zoogenie	f
volta	f
extratextualitate	f
ortogeneză	f
preşedinţie	f
bineţe	f
esenţialitate	f
cepuit	n
didactogenie	f
japcă	f
alocromatism	n
escudo	m
foioase	f
ataxie	f
zemurcă	f
pipernicie	f
colagog	n
radiogeologie	f
poligenie	f
lezard	m
eroologie	f
necioplire	f
toluen	n
ierbărit	n
olfactologie	f
academism	n
teomanţie	f
fărâmare	f
eugenetică	f
bale	f
molia-strugurilor	f
columbiu	n
columbit	n
civism	n
birotică	f
antidemocratism	n
dispreţ	n
preistorie	f
epigonism	n
termologie	f
orfism	n
camgarn	n
foamete	f
eticism	n
astralitate	f
şovar	m
cinepanoramic	n
astralit	n
ladină	f
epistaxis	n
franciscă	f
matroclinie	f
părinţenie	f
bombasticism	n
şirting	n
epireologie	f
ombilicare	f
bibiluri	n
intimism	n
topspin	n
decadentism	n
detresă	f
comiţialitate	f
iţăraşi	m
discant	n
actinot	m
incesibilitate	f
antonomasie	f
rizogeneză	f
actinon	n
încercat	n
băiţuit	n
fetişism	n
floricultură	f
încurcare	f
masa-raiului	f
bădiuliţă	m
criptorhidie	f
dezaerisire	f
răsurei	m
paleontologie	f
amforofonie	f
cardiochirurgie	f
muşeţel	m
desfid	n
faringism	n
grijit	n
impulsivitate	f
krennerit	n
cartism	n
fumărie	f
brenoire	f
europenistică	f
hocus-pocus	n
laba-gâştei	f
altocumulus	m
acvicultură	f
alcoolemie	f
târguire	f
pneumonologie	f
flatus	n
megacefalie	f
santonină	f
trestie-de-zahăr	f
reviviscenţă	f
croşetat	n
burdigalian	n
scaiul-dracului	m
anistorism	n
jaleş	m
agnozie	f
gravimetrie	f
ţuşcov	m
radiotelemetrie	f
duripan	n
mercantilistă	f
subalimentare	f
sacramentalitate	f
idempotenţă	f
nupţialitate	f
naţional-socialism	n
chineză	f
willemit	n
factis	n
concasare	f
diatonism	n
rusofobie	f
spodumen	n
bradichinezie	f
vindobonian	n
impalpabilitate	f
fiziognomonie	f
maleină	f
macabritate	f
neurolingvistică	f
roza-vânturilor	f
anecdotism	n
unidimensionalitate	f
triangulare	f
sigmatism	n
abundenţă	f
gastroterapie	f
carbodiamidă	f
germaniu	n
proteinemie	f
speculativitate	f
würmian	n
taxidermie	f
jelire	f
sânge-rece	n
îmbuşonare	f
imprevizibilitate	f
înseriere	f
monogenie	f
magdalenian	n
filotimie	f
înăcrire	f
etnoistorie	f
citogenetică	f
pecari	m
babuvism	n
vizionarism	n
exemplaritate	f
dermatovenerologie	f
maltoză	f
consumpţie	f
reaclimatizare	f
paludism	n
paride	f
erogenitate	f
vitaminologie	f
audiometrie	f
anxietate	f
hiperraţionalizare	f
dermatină	f
embriocardie	f
cămaşa-broaştei	f
colesterină	f
textualism	n
galactoză	f
unitarism	n
velobol	n
psihroterapie	f
hebertism	n
opozabilitate	f
cinologie	f
sinteaze	f
petrolatum	n
renting	n
fototropism	n
caric	n
pseudoetimologism	n
havat	n
do	m
ecologism	n
scara-Domnului	f
charismă	f
rădăcină-dulce	f
calofilie	f
prepubertate	f
preget	n
amărătăciune	f
foşnit	n
cazeinat	n
iscălit	n
înconjurare	f
cromocolorgrafie	f
gastralgie	f
activină	f
fleancă	f
rizoto	n
cob	m
asemie	f
lâna-broaştei	f
echinism	n
cantometrie	f
anandrie	f
monocameralism	n
pirofobie	f
tahifemie	f
hidrosadenită	f
apologetism	n
ontogonie	f
pedogeografie	f
similaritate	f
scorificare	f
fluorografie	f
ochelari	m
zgârie-nori	m
granulit	n
carnavalizare	f
yatren	n
argiroză	f
comutativitate	f
stimabilitate	f
umbral	n
molibden	n
cver	n
metamorfism	n
canabinol	n
grataj	n
arat	n
bradiartrie	f
strigoime	f
meticulozitate	f
luminanţă	f
rădăcina-ciumei	f
grizzly	m
nucă-de-stejar	f
transportare	f
abalienare	f
patrologie	f
cianozare	f
ablactaţie	f
caşeu	n
etnogeologie	f
negociabilitate	f
climacteriu	n
drajefiere	f
iuncherime	f
memorand	n
gangsterism	n
preziuă	f
patofobie	f
totalitarism	n
molă	f
nazalitate	f
teodicee	f
manganism	n
galvanocromie	f
podofilină	f
galvanoterapie	f
electrofobie	f
ogrinji	m
nerăbdare	f
termosferă	f
tesla	f
cacao	f
dionină	f
cinetehnică	f
artificiozitate	f
ordovician	n
geoistorie	f
desmografie	f
heterosexualitate	f
calevri	m
bolus	n
trepidare	f
zona	f
ripolin	n
zootehnică	f
reflotare	f
răcoritoare	f
tafrolit	n
blast	m
primipare	f
indicanurie	f
italiană	f
zmeură	f
disrupţie	f
neoretorică	f
erotografomanie	f
pauperism	n
afluenţă	f
nefropatie	f
brodat	n
piatră-acră	f
silurian	n
enterologie	f
caracteropatie	f
vanilină	f
dispersiometrie	f
sinopsis	n
uzbecă	f
junie	f
chiliasm	n
comparativism	n
planorism	n
marasm	n
anticvă	f
nativitate	f
etotehnică	f
bioecologie	f
consubstanţialitate	f
holopatie	f
metalism	n
metaforicitate	f
alienabilitate	f
nectarie	f
văsărie	f
cerebralism	m
argăţime	f
nihilism	n
mohoreală	f
jale_de_grădină	f
bănet	n
camerată	f
lapin	m
revărsat	n
polarografie	f
peşte-cu-spadă	m
uzufruct	n
endodonţie	f
astroscopie	f
arierate	f
ulaj	n
lepădat	n
nitrogen	m
sultanină	f
radioestezie	f
demonofobie	f
micopaleontologie	f
transpirat	n
feloderm	n
lehime	f
stridor	n
relativism	n
flint	n
operabilitate	f
codism	n
colţul-babei	m
trestie-spaniolă	f
ciancobalamină	f
lacticemie	f
amoar	n
cocsochimie	f
hemorinie	f
avicultură	f
turcologie	f
cinegrafie	f
catehizare	f
bernă	f
glauberit	n
labiolectură	f
dresuri	n
hidrocosmetică	f
epicriză	f
etnomuzicologie	f
selecţionism	n
magnetostricţiune	f
tenis	n
ortodoxism	n
toreutică	f
demecologie	f
oftalmologie	f
paciuli	f
antropogeografie	f
înghesuit	n
pandajmetrie	f
scheunat	n
anatomie	f
caolinit	n
declarativism	n
anacrotism	m
angelizare	f
însămânţat	n
holofitism	n
nuclearizare	f
eholot	n
estonă	f
cupa-vacii	f
helcologie	f
amonal	n
oncogeneză	f
profunditate	f
anglicizare	f
optimism	n
coţcă	f
beoţian	m
endoplastă	f
alcoolomanie	f
crambe	f
ofiţerime	f
nemiluită	f
conchiliologie	f
ciuboţica-cucului	f
panlirism	n
zvelteţe	f
botanizare	f
simbiotrofism	n
păresimi	f
anacruzie	f
pana-zburătorului	f
telmatologie	f
asinitate	f
insonoritate	f
cloasmă	f
tehnocraţie	f
criminologie	f
cadră	f
tehnofobie	f
presopunctură	f
actualism	n
soia	f
exomorfism	n
diclormetan	m
captivare	f
fototelegrafie	f
nonpareil	n
maclare	f
antropopatie	f
arameană	f
grafomanie	f
labium	n
diatomit	n
porc-spinos	m
nicrom	n
nanism	n
inexperienţă	f
cosmofizică	f
diafonometrie	f
minuturi	n
configuraţionism	n
urologie	f
lexicografie	f
tetramorf	n
neurobiologie	f
medievistică	f
literaturitate	f
propanonă	f
edentaţie	f
meteorică	f
întâietate	f
umiditate	f
cuminţenie	f
cinematografiere	f
poame-de-pământ	f
flotaj	n
hadrom	n
hadron	n
etnosemiotică	f
cruditate	f
băieţică	m
gleizare	f
îndocare	f
vască	f
şalvari	m
cauliflorie	f
tensometrie	f
egomism	n
treiaj	n
andezin	n
autodistrugere	f
astrofobie	f
colargol	n
adormire	f
electroaprindere	f
atavism	n
demonism	n
deînmulţit	n
idiobotanică	f
sifilofobie	f
polan	n
rufărie	f
podologie	f
paradiabet	n
caloză	f
vacuumare	f
durligi	m
candida	f
zimologie	f
rasism	n
colonelă	f
eunuchism	n
monetică	f
dantism	n
râcă	f
chirografie	f
slujitorime	f
radiotelevizare	f
compasiune	f
ecologie	f
protoplasmă	f
pirofilie	f
artizanie	f
tautomerie	f
caniţie	f
arvunire	f
practicitate	f
americanistică	f
aritmofobie	f
poporanism	n
balneografie	f
pruderie	f
petunizare	f
nefelometrie	f
moale	n
vu	m
ireversibilitate	f
translatare	f
string	n
rezinol	n
frăsinică	f
germinal	m
fa	m
zoofilie	f
sizigie	f
electrobeton	n
schizotimie	f
dandism	n
duopol	n
animism	n
ferocrom	n
pirex	n
frasnian	n
ignipunctură	f
addenda	f
neutralizaţie	f
chinotehnie	f
păstură	f
albinism	n
strugurii-ursului	m
spata-draculul	f
răscoage	f
arheochimie	f
javart	n
microporos	n
ciclopie	f
trinitroglicerină	f
textin	n
analogon	n
pus	n
tencuit	n
chemosinteză	f
fugozitate	f
clonus	n
polihibridism	n
gadolonit	n
entelehie	f
conglobaţie	f
teleautografie	f
rizibilitate	f
târnomată	f
imediatitate	f
tabulaţie	f
spinone	m
senilitate	f
propanol	n
actinobiologie	f
scrupulozitate	f
conurbaţie	f
termoaprindere	f
armonizabilitate	f
colapsoterapie	f
fenofază	f
cloroformism	n
biotom	n
moderantism	n
încumetare	f
scradă	f
cariochineză	f
preliminarii	n
antistatizare	f
chemitipie	f
concupiscenţă	f
tusor	n
conceptism	n
rudărie	f
ubertate	f
pectizare	f
volei	n
spongiozitate	f
splanhnologie	f
colectivism	n
arieraţie	f
iepurime	f
laringism	n
izobutan	n
uvarovit	n
nevrozare	f
afidarit	n
austromarxism	n
clavar	m
badminton	n
doping	n
cardiologie	f
asfinţire	f
contrasemnare	f
încălţat	n
solidago	m
sintalitate	f
otavă	f
transsubstanţiaţiune	f
rilsan	n
buha-verzei	f
cotaţie	f
poliizopren	m
protestantism	n
cocacolizare	f
tactilitate	f
triplicitate	f
travestism	n
concesivitate	f
cioplit	n
angulaţie	f
fantezism	n
gazetărie	f
reticulină	f
palma-Maicii-Domnului	f
mamaie	f
cineramă	f
potasiu	n
talasografie	f
stirax	m
halometrie	f
catolicitate	f
magnetometrie	f
rabiofobie	f
adormiţele	f
eurofobie	f
stilografie	f
şamoa	m
scărmănat	n
înclichetaj	n
şomaj	n
metalochimie	f
herme	f
filodoxie	f
psihologie	f
heroină	f
vădrărit	n
macrocosm	n
rut	n
croată	f
barbotină	f
ortodonţie	f
pompierie	f
motonautică	f
capotare	f
maloniluree	f
soliton	n
scărpinat	n
vernis	n
morfometrie	f
forfotă	f
presărat	n
statu-quo	n
bacilurie	f
sinoptică	f
nobilitare	f
autocod	m
idiomorfism	n
histochimie	f
terosonare	f
ancombranţă	f
presocratici	m
turanit	n
dârzenie	f
obelisc-frontieră	n
termometrie	f
mimetism	n
barot	n
sulfonare	f
scientologie	f
măngăluit	n
intermodulaţie	f
prospeţime	f
hidrosonocitate	f
formativitate	f
redintegraţie	f
malahit	n
valex	n
strabism	n
deambulare	f
zapat	n
autoapărare	f
microfonie	f
acţionalism	n
monometalism	n
apomorfină	f
şapte-degete	m
mondialitate	f
ectogeneză	f
sacâz	n
extrafor	n
măiculeană	f
neogen	n
protiu	n
slavonă	f
laburism	n
direcţionalitate	f
ploier-comun	m
preconcasare	f
refreşare	f
cenuşărit	n
ambarcare	f
hipopatologie	f
narcotism	n
vanadinit	n
mixtiune	f
celeritat	f
fonografie	f
lung	n
dezonoare	f
climatip	n
clămpănit	n
activism	n
islamism	n
termoacustică	f
paleologie	f
emendanda	f
ecu	f
ionosferă	f
ancestru	n
petrografie	f
panus	n
mecibol	n
asociaţionism	n
bronzit	n
zimotehnie	f
adaptabilitate	f
parcurgere	f
conga	f
subiectivitate	f
parvenitism	n
dilatabilitate	f
terţia	f
pseudostereofonie	f
cultivaţie	f
elefantiazis	n
festivism	n
sardonix	n
bordee	f
mârâit	n
asibilare	f
cerumen	n
geozoologie	f
spermatografie	f
tuşit	n
elaboraţie	f
polemologie	f
dendrometrie	f
electroceramică	f
ciuma-apelor	f
silogizare	f
sulfocarbonism	n
criobiologie	f
criobionte	n
tehnicism	n
trombocitopenie	f
aşteptat	n
dehiscenţă	f
poala-Sfintei-Marii	f
geobiologie	f
contactologie	f
drac-de-mare	m
campimetrie	f
cheratodermie	f
monoideism	n
virga	n
climatologie	f
sitotropism	n
halastâncă	f
arhitectură	f
logopedie	f
wolframit	n
solo	m
cucerie	f
viermăraie	f
analitism	n
calotipie	f
detumescenţă	f
clăncăit	n
platru	n
căzăcime	f
pirocatechină	f
hipotensiune	f
lăcăraie	f
capitularii	n
heteromorfism	n
perisabilitate	f
miambal	n
zbârcire	f
tireoglobulină	f
gonion	n
muiercea	m
telebiometrie	f
horăit	n
stalagmometrie	f
circularitate	f
greime	f
iobăgire	f
anonimografie	f
soarbe-zeamă	m
posibilism	n
condominiu	n
imunologie	f
amoniu	n
acvifaună	f
ponosire	f
dinanţian	n
gliptică	f
realezare	f
cercuit	n
anoftalmie	f
gestapo	n
samsara	f
fata	f
bongoase	f
luare-aminte	f
macrobie	f
diagnosticare	f
saiga	f
ergografie	f
inactivitate	f
ciordit	n
pipăit	n
turingit	n
patogeneză	f
floculaţie	f
mălai-mare	m
seismoterapie	f
cauzalitate	f
muciorniţă	f
doctorizare	f
negativitate	f
jind	n
efectivism	n
salvarsan	n
latinomanie	f
reprografie	f
butan	m
reîncepere	f
alogamie	f
importunitate	f
semiologie	f
predeterminare	f
hipermetropism	n
proeresis	n
folio	n
folia	f
fluorfosgen	n
empirie	f
teletax	n
crepdeşin	n
aeronomie	f
silice	f
viceamiralitate	f
paradoxalism	n
sociomorfologie	f
mecanicitate	f
manierare	f
naturalism	n
enologie	f
bioindustrie	f
poliş	m
nea	f
nep	n
neveu	n
telefonie	f
omag	m
cehă	f
intelectualism	n
lânică	f
programabilitate	f
alizarină	f
aculturalizare	f
tautacism	n
fitofarmacologie	f
refilare	f
dezaharificare	f
ofiografie	f
perpetraţie	f
piculeţ	n
sulfidare	f
iluzionism	n
măcriş	m
cloretonă	f
jubeu	n
zoobiologie	f
ataraxie	f
egerie	f
şerbie	f
cachetero	n
interfoliaj	n
lezmaiestate	f
inabilitate	f
gutapercă	f
înţelepciune	f
exoreism	n
fibrociment	n
descotorosire	f
chehailâc	n
hegiră	f
acromie	f
astronautică	f
sincopism	n
penetrologie	f
bantu	m
burghiere	f
nuizibilitate	f
structuralitate	f
androsteron	m
potenţialitate	f
statornicie	f
ramoleală	f
cantaridină	f
ininteligenţă	f
angelus	n
contemplativitate	f
gagliardă	f
discutabilitate	f
orpiment	n
calimetrie	f
motorină	f
caraibi	m
henoteism	n
hârcâit	n
scârţa-scârţa	m
aureomicină	f
radiodistribuţie	f
ireligiozitate	f
gândirism	n
traheobacterioză	f
coercibilitate	f
tiflopsihologie	f
discursivitate	f
miere	f
teckel	m
calafat	n
mizericordie	f
apiol	n
metaloterapie	f
parotide	f
cicloalcan	m
împietrire	f
prezumţiozitate	f
leucopenie	f
meoţian	n
facoscopie	f
cincantin	m
atractanţi	m
bradifazie	f
plasticitate	f
algebrizare	f
virusologie	f
bibliologie	f
druidism	n
tehnosferă	f
cal-turtit	m
hipertimie	f
anizotropie	f
ubichinonă	f
agănău	n
exigibilitate	f
bigeminism	n
cazualitate	f
pecetluit	n
autoblocare	f
ultimogenitură	f
înşfăcare	f
acnee	f
globoid	n
cristalografie	f
probitate	f
hialofobie	f
silvobiologie	f
patetism	n
hămeseală	f
helicicultură	f
semiclandestinitate	f
cobaltit	n
triplum	n
olonimie	f
berilioză	f
untul-vacii	n
compatibilitate	f
in	m
mahmur	n
albedo	n
imobilism	n
funcţionarism	n
contextuare	f
mazdeism	n
eburnare	f
caporalism	n
villafranchian	n
masonerie	f
nesăbuire	f
zarvă	f
cerebropatie	f
electroplasmoliză	f
zară	f
pretorianism	n
bilingvism	n
granulie	f
occident	n
contrapapă	f
electrobiologie	f
constituţionalizare	f
alelism	n
biodegradare	f
japonezărie	f
osteoză	f
papagalism	n
buri	m
junimism	n
urlat	n
nectarii	f
artnapping	n
vulcanologie	f
zuf	n
adjectivizare	f
carting	n
bunăvoie	f
despărţeală	f
câinele-babei	m
baroterapie	f
corrigenda	f
imunochimie	f
spermă	f
dogmatism	n
plănuire	f
maşinism	n
marinare	f
atomistică	f
anecdotică	f
năvălnicie	f
metodologie	f
meliorism	n
wulfenit	n
nesimţite	n
zaibăr	n
bură	f
ordinatică	f
conţinutism	n
metodism	n
imperforat	n
barestezie	f
mahonare	f
pirotehnică	f
nobilime	f
olandă	f
endoreism	n
venerabilitate	f
citopoieză	f
primet	n
egresiune	f
anatexie	f
metempsihoză	f
antediluvian	n
dinghi	n
mei-nebun	m
hipotiroidism	n
septentrion	n
indoeuropenism	n
boccia	n
simpatologie	f
etate	f
zambilă-moţată	f
geropsihiatrie	f
reologie	f
sentenţiozitate	f
teatralizare	f
neutralitate	f
plebiscitarism	n
poliţism	n
mestecat	n
inoportunitate	f
cvadrimaran	n
leucină	f
evaporimetrie	f
lanital	n
înspăimântare	f
calorimetrie	f
epifitism	n
muşcat	n
confuziune	f
atrepsie	f
adiacenţă	f
asiatistică	f
concreţionare	f
homeopatie	f
barbă-albastră	m
cidru	n
jais	n
tălpăşiţă	f
endobiologie	f
narcobioză	f
supramuncă	f
glaspapir	n
inosită	f
ctenologie	f
climatopatologie	f
parorexie	f
entuziasmare	f
telepatie	f
echilibraţie	f
pneumoftiziologie	f
calinerie	f
catolicism	n
diabolism	n
tăicuşor	m
bătrânet	n
muşuroit	n
pufărie	f
pieire	f
rod-de-zahăr	n
coafat	n
împâslire	f
puricească	f
telur	n
dextrocardie	f
etnicism	n
sculpturalitate	f
şcolarizare	f
marcocartofilie	f
lactofruct	m
reflectografie	f
incastelură	f
didactecă	f
venturi	n
prevalare	f
sulf	n
logaritmare	f
bulonare	f
regina-nopţii	f
letrism	n
lexicalizare	f
agonistică	f
teflon	n
kiş-miş	n
parkinsonism	n
sectorizare	f
domesticitate	f
astrospectroscopie	f
retranşare	f
pluviometrie	f
creozot	n
ruteniu	n
metalogică	f
ghircă	f
acuitate	f
tipometrie	f
ebraistică	f
capsulare	f
gamofobie	f
suprafluiditate	f
mecena	m
citochimie	f
puma	f
pluripartitism	n
samă	f
arhaicitate	f
rupt	n
lăsat	n
reinserţie	f
cârpăcie	f
habar	n
iactanţă	f
magno	n
ciupit	n
rugbi	n
mortinatalitate	f
congeminaţie	f
electromecanică	f
suicid	n
tuşinare	f
picioare-lungi	n
cărat	n
ţanţoşie	f
etnoastronomie	f
stereofotogrammetrie	f
argilolit	n
sucit	n
legitimism	n
şerlac	n
neocapitalism	n
tehopatologie	f
filozitate	f
buglovian	n
plebeism	n
astâmpăr	n
parizianism	n
malignizare	f
pumnism	n
biosociologie	f
corn-de-secară	n
clandestinitate	f
anastigmatism	n
ornamentică	f
sinter	n
ectrogenie	f
moca	f
azeotropism	n
politomie	f
auxometrie	f
epirogeneză	f
baschetbal	n
normosexualitate	f
înzdrăvenire	f
transculturaţie	f
sudat	n
nitrotoluen	n
toxicitate	f
analogizare	f
cubomanie	f
spiralare	f
vânzolit	n
masivitate	f
ebraizare	f
indispensabili	m
nuvelistică	f
hidroxilamină	f
hirudinicultură	f
reparat	n
biostazie	f
picuriş	n
adorare	f
ludlow	n
suedeză	f
universalism	n
acidoză	f
zoomagnetism	n
dialectizare	f
eudemonologie	f
vertex	n
împachetat	n
afototropism	n
holomorfoză	f
lias	n
straiţa-popii	f
liaj	n
biogeocenoză	f
săsime	f
cacodilat	m
platonism	n
rusofilie	f
radiologie	f
clandestinism	n
lâncezeală	f
gimnospermă	f
fuzit	n
dezicere	f
târâie-brâu	m
leishmanioză	f
termoscopie	f
renivelare	f
secretină	f
geocronologie	f
filobiologie	f
smuls	n
arivism	n
groază	f
pirolatrie	f
tapaj	n
neştiinţă	f
desmin	n
culturalism	n
bromocet	n
butil	n
ucigă-l-crucea	m
fixare	f
narodnicism	n
eozofobie	f
fală	f
productivitate	f
acotiledone	f
malofagie	f
aerarium	n
găina-lui-Dumnezeu	f
numismatică	f
decoromanie	f
semitologie	f
malachit	n
failibilitate	f
valabilitate	f
self-control	n
fulguit	n
neoplatonism	n
galactit	n
prăfăraie	f
comunicativitate	f
gaiac	m
desmopatie	f
predicativitate	f
tarsoclast	n
anominaţie	f
editologie	f
dolly	n
delineavit	n
farinogramă	m
pandemoniu	n
impresionabilitate	f
europenizare	f
gefirofobie	f
shakespearologie	f
telegenie	f
învăţ	n
mecanotelie	f
glosologie	f
exotism	n
neautenticitate	f
climatoterapie	f
petrarchism	n
caravani	m
supuşenie	f
friabilitate	f
prejudiciere	f
anartrie	f
stampian	n
feculă	f
ecotoxicologie	f
angiogenie	f
letalitate	f
uşurătate	f
ideogenie	f
galbenă	f
lactar	m
bărbunc	n
căscare	f
cesiu	n
baştină	f
serotonină	f
colbărie	f
rărit	n
caldecan	m
behaviorism	m
vlagă	f
orlon	n
mişto	m
cauda	f
ebraică	f
spiritualitate	f
impudicitate	f
tehnostructură	f
geonim	n
refractometrie	f
discredit	n
cataplexie	f
reedificare	f
înfăţare	f
temut	n
invazitate	f
instinctivitate	f
scândurărie	f
ghimber	m
endocrinie	f
varvă	f
dualism	n
parafucsină	f
împuşcă-n-lună	m
plămădit	n
criotehnică	f
telefagie	f
legumărit	n
tartraj	n
arimare	f
hovercraft	n
defectologie	f
cacosmie	f
borax	n
deşertat	n
meconină	f
exhaustiune	f
ortostatism	n
clocire	f
etilaţie	f
fux	n
micsandră-de-munte	f
antijunimism	n
părâng	m
sfagnologie	f
scuturat	n
stricninism	n
gaci	m
tacet	n
evazivitate	f
legănat	n
şest	m
cristalogenie	f
stocastică	f
guano	n
pisică-de-mare	f
entomofaună	f
diaftoreză	f
dacrioree	f
cameleonism	n
deleatur	n
scenicitate	f
scripte	f
păsat	n
prerafaelitism	n
enculturaţie	f
mistagogie	f
reinfestare	f
sulfocianură	f
mimologie	f
ţărănism	n
crotonil	n
iminei	m
biogeografie	f
refinanţare	f
sleit	n
sirologie	f
ergodicitate	f
genitalitate	f
antimilitarism	n
încheiat	n
benzedrină	f
cetosteroid	m
peş	n
lambliază	f
nepotism	n
păruit	n
păstorie	f
filaliu	n
mărăraş	m
leuştean	m
gadoliniu	n
oiconimie	f
ofsetipie	f
chirologie	f
cantaridism	n
imponderabilitate	f
cartuşerie	f
acvilon	n
replicaţie	f
instauraţie	f
cuţulan	m
păstorit	n
sumaritate	f
leucopoieză	f
dogger	n
cuprism	n
cucuruzaştină	f
celochit	n
papism	n
eferenţă	f
inexcitabilitate	f
granulat	n
cvintupli	m
ombrofobie	f
ruşine	f
anticristianism	n
saurografie	f
cardioplastie	f
fascioloză	f
schiatron	n
paternitate	f
preştiinţă	f
antigel	n
crop	n
crom	n
cablaj	n
hidatidă	f
morbiditate	f
feroaluminiu	n
hemoroizi	m
carboxihemoglobină	f
caşa	f
castravete-de-mare	m
optică	f
doctoralitate	f
exoterism	n
eugenol	n
dromateriu	m
echipotenţialitate	f
percalină	f
defectivitate	f
încălzit	n
galvanotipie	f
caşă	f
stereoacustică	f
rapacitate	f
limnimetrie	f
areologie	f
icastică	f
rabdomanţie	f
autoculpabilizare	f
astenizare	f
treacăt	n
catrafuse	f
fotoconductibilitate	f
inclemenţă	f
prelucrabilitate	f
reometrie	f
ermetizare	f
ultraelaborat	n
nestabilitate	f
bonderizare	f
garmond	n
electricitate	f
jejunită	f
teratologie	f
cine-adevăr	n
valonă	f
jocoterapie	f
plastică	f
neurochimie	f
redevelopare	f
adamism	n
ambou	n
juniorat	n
aspirantură	f
palinologie	f
prozopografic	f
decurs	n
grosular	n
credulitate	f
pifă	f
paliditate	f
solaritate	f
litină	f
pierde-vară	m
anadipsie	f
acromanţie	f
penologie	f
sinigrină	f
ţâţa-mielului	f
înjumătăţire	f
matematism	n
geopolitică	f
verbomanie	f
vinasă	f
skleron	n
indianistică	f
muzicoterapie	f
hidrometrie	f
eruptivitate	f
incoagulabilitate	f
electronică	f
diamagnetism	n
handbal	n
navomodelism	n
heterosporee	f
salbă-moale	f
blaugaz	n
ciclizare	f
absurd	n
omniscienţă	f
transcendentalism	n
canelare	f
areal	n
cheltuire	f
soldăţie	f
amidon	n
amidol	n
concomitenţă	f
increat	n
nefelomanţie	f
goniografie	f
anorhidie	f
madam	f
reabonare	f
gigantomahie	f
hialit	n
nictofobie	f
analecte	f
spalaţie	f
fideiusiune	f
justeţe	f
punctualitate	f
ramazan	n
macairodus	m
agropedologie	f
etnocoregrafie	f
încujbare	f
termoestezie	f
citozină	f
iudaism	n
iatromanţie	f
mioglobină	f
epizoocorie	f
cronobiologie	f
colecţionism	n
izomerie	f
inextensibilitate	f
camaieu	n
balistofobie	f
neotenie	f
iridologie	f
studenţime	f
jidănime	f
retard	n
încălţăminte	f
fructidor	m
mielografie	f
fornăit	n
solanism	n
melotron	n
electroacupunctură	f
bagasă	f
integrism	n
calicenie	f
glosodinie	f
plombagină	f
baciliscopie	f
balbuţie	f
salată-de-câmp	f
salată-creaţă	f
est	n
tebece	n
versatilitate	f
ostăşime	f
soman	n
endolimfă	f
dinţătură	f
providenţialism	n
cezarism	n
colporafie	f
aerofagie	f
glauconit	n
matriarhat	n
poetică	f
hetairism	n
manierism	n
bus	n
buh	n
muhur	n
şlefuit	n
esculină	f
panificaţie	f
styroflex	n
zi-muncă	f
distensie	f
butirină	f
cerbicie	f
fluor	n
obtuzie	f
fideism	n
egiptologie	f
detensionare	f
farmacoterapie	f
documentică	f
ecluziune	f
surdomutism	n
loialitate	f
exsanguitate	f
neicuţă	m
chimiotactism	n
pirometalurgie	f
laxitate	f
curama	f
senin	n
cheratină	f
hepatism	n
contagiozitate	f
pirargirit	n
cipolin	n
gamomanie	m
mitocondrie	f
drosel	n
convertografie	f
topofobie	f
identificaţie	f
ficţionalitate	f
sigillaria	f
leucopatie	f
vascularitate	f
paleobiogeografie	f
bazofobie	f
minerit	n
deşteptăciune	f
deuteriu	n
amauroză	f
viscere	n
depolizare	f
antemiom	n
bună-credinţă	f
matalotehnică	f
feticid	n
supravieţuire	f
arteriologie	f
albastru	n
stigmatism	n
orogenie	f
dactilologie	f
telofază	f
onix	n
perscrutaţie	f
penaţi	m
bacteridie	f
ivorin	n
dumerire	f
redirecţionare	f
enomanie	f
prognatism	n
fonomimie	f
îmbătrânire	f
ofiofagie	f
nătărăie	f
bacterioterapie	f
distragere	f
dermatologie	f
canto	n
farmacognozie	f
absolutism	n
autenticitate	f
alcalizare	f
umplut	n
zăhărele	n
biomicină	f
nivelaţie	f
lâneturi	n
fiziocraţie	f
slavonie	f
angarie	f
răposare	f
blenoree	f
anurie	f
aluminotermie	f
ludwigit	n
hiperfoliculinie	f
expo	n
verminaţie	f
limfopoieză	f
opţionalitate	f
albit	n
pădurărit	n
fălcariţă	f
mercantilizare	f
epifenomenalism	n
flox	m
trăncănit	n
vânătorime	f
magnadur	n
preconcentrare	f
rotoţele	f
algomanie	f
pitoresc	n
clătinat	n
aspersiune	f
tirighie	f
geotropism	n
antropomorfoză	f
cefalee	f
paradiafonie	f
pacifism	n
diploe	f
vileag	n
iobăgime	f
otografie	f
orzuleţ	n
corutină	f
drăgostire	f
intrat	n
hibridaţia	f
veratrină	f
smectită	f
conicitate	f
nefrografie	f
metanizare	f
epidermoliză	f
revocabilitate	f
conservatorism	n
închircire	f
claustromanie	f
tebaină	f
broşat	n
trinitrat	m
absconsitate	f
adipsie	f
rix	n
culminare	f
dragonade	f
lugol	n
paradoxism	n
frământ	n
holocen	n
fătat	n
indoeuropenistică	f
atonalism	n
bacterioliză	f
strecurat	n
pizzicato	n
acluofobie	f
cătănie	f
succesivitate	f
monumentalism	n
grecomanie	f
electrocapilaritate	f
bocit	n
sănătate	f
brichetaj	n
aliosis	n
afluiere	f
termidor	m
efluenţă	f
citrice	n
iluminism	n
varegi	m
monoteism	n
corm	n
cori	n
neuroradiologie	f
benzoil	m
piezografie	f
etnopedagogie	f
băieşime	f
validitate	f
troostită	f
tiamină	f
mamacă	f
hormism	n
eritropoieză	f
xografie	f
medius	n
poichilotermie	f
nervism	n
audibilitate	f
asindeton	n
clingherit	n
centralism	n
lituaniană	f
scârbe	f
grafism	n
descărcat	n
ordeolum	n
greacă	f
dilacerare	f
retropropulsie	f
barifonie	f
erudiţie	f
nevrax	n
paleogeofizică	f
nosologie	f
tverdu	m
verosimilitudine	f
comensalism	n
instrumentare	f
tuaj	n
raţiocinare	f
milostivă	f
flanger	n
roving	n
schizoidie	f
batracocultură	f
candizare	f
genulieră	f
febră	f
politeism	n
fecundat	n
pupilometrieie	f
fatigabilitate	f
windkanter	n
cinofobie	f
radiotelegrafie	f
modernitate	f
plusvaloare	f
consecutivitate	f
salba-dracului	f
dinamism	n
galvanocaustică	f
panism	n
serviabilitate	f
purificat	n
prânzare	f
rumânie	f
angelină	f
tamponadă	f
artificializare	f
cosmofotogrammetrie	f
fleaşcă	f
umbra-iepurelui	f
atetoză	f
acrocefalie	f
neoimpresionism	n
fango	n
îndosariere	f
agerazie	f
algină	f
sinergism	n
glicogeneză	f
silvanit	n
dogmatică	f
teroare	f
eşafodare	f
aboliţie	f
gomenol	n
soare-apune	m
realism	n
neaşteptate	n
reclasificare	f
răpunere	f
sociogonie	f
nebăute	n
alios	n
iarbă-albă	f
lânărică	f
aglutinogen	m
bavă	f
pedepsie	f
hidrogamie	f
motănaş	m
găurit	n
calcinoză	f
comparabilitate	f
vivianit	n
angelitate	f
diamonfos	m
dezmiriştit	n
ozalid	n
stârpit	n
higromorfism	n
aviditate	f
muscălime	f
ceapa-ciorii	f
epigamie	f
cetologie	f
impermeabilitate	f
teraforming	n
epigenie	f
motănime	f
microsomi	m
pediometrie	f
recipe	n
fiscalism	n
carbohemoglobină	f
edafologie	f
biocalorimetrie	f
atomizare	f
indemonstrabilitate	f
bioluminescenţă	f
tarhon	m
mătuşică	f
politicianism	n
robotică	f
rinologie	f
indianologie	f
inişor	m
radiumterapie	f
salitru	n
siciliană	f
neuropsihiatrie	f
fizioterapie	f
roua-cerului	f
carmelină	f
amitoză	f
acioaie	f
violabilitate	f
cafeu	m
înfierbântat	n
teleobservare	f
polo	n
gunoit	n
entranţă	f
izotomie	f
hipofizare	f
velur	n
hidrostatică	f
malthusianism	n
coplanaritate	f
venozitate	f
botanologie	f
arheografie	f
posteritate	f
bismark	n
jefuit	n
obsolescenţă	f
cărunţeală	f
serialism	n
statuară	f
chimizare	f
muţie	f
sfincteralgie	f
aneuploidie	f
pontat	n
libido	n
amuzie	f
municipalism	n
moder	n
ferecat	n
patristică	f
concordism	n
simpatic	n
parian	n
clor	n
hedonistică	f
stârpire	f
crioscopie	f
congenialitate	f
brânză	f
multiplicitate	f
fenogeneză	f
electrografie	f
operaţionalitate	f
nictalopie	f
seleniu	n
năjit	n
gatofobie	f
protocronism	n
splenopatie	f
priapism	n
nudism	n
atropină	f
convenţionalizare	f
ametropie	f
scârţâit	n
iulie	m
gigantizare	f
paleogenetică	f
polimetrie	f
concretism	n
catecolamine	f
enfeu	n
revopsit	n
forfetare	f
terminus	n
indo-europeană	f
zoopatologie	f
iredentism	n
lumpenproletariat	n
celiopatie	f
clonism	n
moscovian	n
lancasterianism	n
afum	n
fetie	f
psihiatrie	f
disociabilitate	f
reflaţie	f
anatomopatologie	f
montanism	n
heterotrofie	f
năsădit	n
velveton	n
filtrat	n
comisiune	f
gaeli	m
uniformologie	f
coprologie	f
cauă	f
osianism	n
radiestezie	f
pneumologie	f
nelucrare	f
harabaie	f
dinasticism	n
lapili	m
pergelisol	n
pioree	f
magnanimitate	f
cucurigat	n
extensivitate	f
cumsecădenie	f
epică	f
colecţiomanie	f
zootaxie	f
comparatism	n
machism	n
hidrometalurgie	f
briantină	f
cromoterapie	f
galvanotaxie	f
microcronologie	f
ometiţă	f
voltolizare	f
apatit	n
fixitate	f
partinitate	f
culcat	n
rişcă	f
biplacă	f
pilit	n
imaterialism	n
găsire	f
ayatolah	m
saturabilitate	f
refrişare	f
cifoscolioză	f
potamofobie	f
clasicitate	f
estran	n
acarologie	f
protoistorie	f
căruţărie	f
gherilă	f
eretism	n
levănţică	f
coada-calului	f
alter	m
cesionare	f
dialit	n
extensibilitate	f
morozitate	f
acvadag	n
imagism	n
nosofobie	f
sporadicitate	f
desămânţare	f
untdelemn	n
monolingvism	n
imunogenetică	f
sudabilitate	f
micologie	f
culturologie	f
glasiu	n
prostituţie	f
tricloretilenă	f
neiculean	m
celadonit	n
diamalţ	n
zahărel	n
volhinian	n
trei-fraţi-pătaţi	m
hidraulică	f
clavicimbal	n
libidinism	n
canavăţ	n
capabilitate	f
decenţă	f
îndesire	f
cargo	n
esenţialism	n
farmacomanie	f
feudalism	n
dărăpănare	f
regradare	f
fluture-roşu	m
pusilanimitate	f
aplicativitate	f
masochism	n
termoprotecţie	f
heliocentrism	n
litocromie	f
frânghierit	n
apă-grea	f
statism	n
decarboxilare	f
aritmomanie	f
stea-de-mare	f
octostil	n
angofrazie	f
hâci	n
rubicel	m
biostimulare	f
ginecofilie	f
kendoka	m
eroism	n
brumar	m
hexametilentetramină	f
pogonărit	n
efectivitate	f
sotare	f
mentism	n
alobrogi	m
dus	n
zoografie	f
contratipie	f
etatism	n
floare-de-leac	f
noaieu	n
pancivilizaţie	f
biodinamică	f
vermiculit	n
peronină	f
sinofilie	f
flaciditate	f
pălămidă-de-baltă	f
autoclazie	f
ornitofilie	f
vraişte	f
statalitate	f
ergonomie	f
proximitate	f
uzi	m
algonkină	f
contemporaneitate	f
cuţit-de-mare	m
obiectualitate	f
simultaneism	n
măsurat	n
timpanism	n
convertibilizare	f
îngemănare	f
paradoxalitate	f
hipomanţie	f
faustpatron	n
hrişcă	f
cerut	n
drişcuit	n
jotă	f
canam	n
algonkini	m
fast	n
viitorologie	f
erpetologie	f
orientalia	f
infern	n
mugit	n
atrofie	f
bulevardism	n
mamelucărie	f
istericale	f
margarină	f
zooplastie	f
suge-bute	m
stronţianit	n
linte	f
endocrinologie	f
seignettoelectricitate	f
gobie	f
plesnire	f
teta	m
capul-ariciului	n
ghidare	f
gangliopatie	f
pemfigus	n
copilit	n
embolofazie	f
stupoare	f
materialism	n
rezistibilitate	f
gâfâit	n
adjutantură	f
încălţare	f
rudimentarism	n
tensionare	f
maţe-goale	m
belinografie	f
ortogenie	f
masculinitate	f
cunico	n
atletică	f
sinonimitate	f
fen	n
planing	n
sorg	m
nefroscleroză	f
dezobstruare	f
fenomenalitate	f
peisagism	n
rondino	n
antipapă	f
poliandre	f
chemigrafie	f
aeronavigaţie	f
deligaţie	f
poturi	m
lăcărie	f
neordine	f
târşâit	n
feculerie	n
ftori-logofăt	m
zooiatrie	f
bentonit	n
succinit	n
spermatogeneză	f
halenă	f
coleterapie	f
hlestacovism	n
văzut	n
malacologie	f
gamagrafie	f
echistică	f
entomografie	f
vântăraie	f
trinitrotoluen	n
aligote	n
rouă	f
cainozoic	n
wagnerism	n
inarmonie	f
împrospătare	f
poterie	f
îngăduire	f
rafinaj	n
etruscologie	f
bordare	f
avangardism	n
odontotehnică	f
culăcime	f
bluzare	f
biogeocenologie	f
prospectologie	f
izotonie	f
buricul-apei	n
durabilitate	f
terţiar	n
taxonomie	f
mudulo	n
pravoslavie	f
onirologie	f
telefonometrie	f
deambulaţie	f
îndrăcire	f
hemoclazie	f
sfredelit	n
pălămărie	f
imiscibilitate	f
ftizie	f
unison	n
taie-fugă	m
cristalomanţie	f
op-art	n
tenopatie	f
anglofobie	f
purgatoriu	n
batracofobie	f
hungarologie	f
autoîncântare	f
olărit	n
parafilatelie	f
rabinat	n
finitism	n
cvadrupli	m
temporalitate	f
bârfit	n
chemoterapie	f
migală	f
imprescriptibilitate	f
confutaţie	f
ablutomanie	f
araucaria	f
fistulizare	f
modelism	n
miozotis	m
homeotermie	f
sardă	f
frigoterapie	f
linearism	n
redistribuţie	f
necrobaciloză	f
bending	n
inflamabilitate	f
săpunit	n
gametogamie	f
anticlericalism	n
fenomenalism	n
luminal	n
hidrocultură	f
luminat	n
haptotrofism	n
eufomanie	f
odiozitate	f
mumbaia	f
senzorialitate	f
hemiceluloză	f
radioteleviziune	f
ţică	m
engleză	f
reumatologie	f
serpasil	n
amenţie	f
stagflaţie	f
post-restant	n
fanerogamie	f
lingoare	f
tătiţă	m
intenţionalitate	f
momiţe	f
linearitate	f
blanşare	f
inadecvare	f
bovidee	n
conştiinciozitate	f
witherit	n
ciclohexanonă	f
galvanism	n
balsa	m
duduit	n
frigana	f
warcops	n
esociforme	f
ceasla	f
albumen	n
hoplolatrie	f
desprimăvărare	f
tactognozie	f
metrologie	f
decima	f
cocaină	f
clipit	n
acmolit	n
carbonifer	n
ecolocaţie	f
geografie	f
genetism	n
sinaxă	f
planctonte	f
atex	n
criticism	n
bacteriolizină	f
scânteiuţa-lupului	f
împăciuitorism	n
carbochimie	f
ostinato	n
sânge-de-nouă-fraţi	m
hiperimunizare	f
rivanol	n
diploidie	f
actinism	n
derivabilitate	f
confeti	f
carnotit	n
molătate	f
hidromorfologie	f
ovogeneză	f
populament	n
textile	f
colţii-babei	m
agrarianism	n
transhuminare	f
deculturaţie	f
mojicime	f
măgăoaie	f
cooperativism	n
re	m
jale	f
cartometrie	f
imunodeficienţă	f
tehnopatie	f
panfobie	f
neîndurare	f
cartiruire	f
vivaristică	f
carpicultură	f
sistemicitate	f
escarificare	f
tenologie	f
rustificare	f
curechi-de-munte	m
carmajin	n
silenţiu	n
durif	m
eristică	f
durit	n
termotacticism	n
mult-puţin	n
astupat	n
ortodoxie	f
neotomism	n
rezecabilitate	f
axometrie	f
etnobiologie	f
detriment	n
edulcoraţie	f
tribotehnică	f
luxurianţă	f
pneumatolite	f
cucută-de-apă	f
iconometrie	f
imunobiologie	f
încetare	f
petit	n
oripilare	f
fiziografie	f
catafront	n
reinvestire	f
radius	n
securit	n
antamare	f
sombrero	n
cutană	f
astrofotometrie	f
imunopatologie	f
spiţuri	n
peştelui	f
nenoroc	n
iridiu	n
candidoză	f
zoonimie	f
tremolit	n
metalosferă	f
stoichiometrie	f
ecofobie	f
aritmetică	f
silvomecanizare	f
slap	n
făţuit	n
neoromantism	n
tombac	n
omisibilitate	f
udat	n
cadrilaj	n
îngustare	f
chemoluminescenţă	f
slovenie	f
polipnee	f
turgescenţă	f
pironire	f
arhivistică	f
agrocenoză	f
securitate	f
micofloră	f
cărunţie	f
bazedov	n
antimarxism	n
buncheraj	n
burtea	m
canavaţă	f
teleologie	f
deferlare	f
funeralii	n
electrotehnică	f
marciavanti	n
neutrino	m
tătărime	f
nifoblepsie	f
geomorfie	f
saţiabilitate	f
iudaistică	f
plugărime	f
politrofie	f
albei	m
apifobie	f
coada-zmeului	f
encaustică	f
drogomanie	f
uşurime	f
puriaz	n
dipsopatie	f
sintagmatizare	f
voluntariat	n
juvenilitate	f
nefiinţă	f
peculiu	n
hidrobotanică	f
sculat	n
sinectică	f
deîmpărţit	n
desuetudine	f
moldavite	f
morfogenie	f
electrosiderurgie	f
ahtiat	n
eritabilitate	f
repetitivitate	f
genuinitate	f
circoramă	f
gastroenterologie	f
vată	f
bună-cuviinţă	f
catoptrică	f
hemoglobină	f
idoneitate	f
elastodinamică	f
omătuţe	f
jetfoil	n
tematologie	f
eticitate	f
antropobiologie	f
kendo	m
mulge-capre	f
iperită	f
duumvirat	n
vioiciune	f
agrafie	f
accidenţe	f
comunitarism	n
invulnerabilitate	f
mele	n
magnetism	n
omogenitate	f
juri	m
etnogonie	f
polidactilie	f
căutat	n
dermatoree	f
maniabilitate	f
rafaelism	n
şevilat	n
receptivitate	f
înlocuire	f
spaghete	f
portarmă	f
ovine	f
carbid	n
caponare	f
nevroglie	f
azbestolit	n
turonian	n
dragoste	f
monitoring	n
papaia	f
ajustabilitate	f
electromecanoterapie	f
asfolit	n
antiistorism	n
imparitate	f
reprezentativitate	f
natural	n
si	m
decalo	n
reiteraţie	f
zăcut	n
clorizare	f
decupat	n
spiritualism	n
excepţionalitate	f
şarm	n
ţâncul-pământului	m
cinofilie	f
orzoaică-de-baltă	f
sorbitizare	f
barometrie	f
panteism	n
algrafie	f
sociotip	n
maximafilie	f
antropologism	n
idilism	n
dermatografie	f
argăsit	n
psihosociologie	f
perilimfă	f
subconsum	n
cârâit	n
inculpare	f
zoofitologie	f
politonalitate	f
şofaj	n
tenebrozitate	f
odontofobie	f
neghină-sălbatică	f
geodezie	f
năvârlii	f
anageneză	f
tetra	n
jansenism	n
recalescenţă	f
digama	m
stresor	n
şelac	n
fibroscopie	f
primatologie	f
strâmt	n
sângerat	n
pălincuţă	f
crochet	n
gaibarace	n
fosfor	n
dolon	n
spaţionare	f
dolor	n
drăcime	f
incoordonare	f
sfigmometrie	f
calcantit	n
osteologie	f
bicromie	f
exhaustivitate	f
fanariotism	n
aminobenzen	m
tetanism	n
succinat	n
deformabilitate	f
metilmorfină	f
izomorfie	f
dinamică	f
bibliometrie	f
bimzuire	f
prescriptibilitate	f
panică	f
păstrat	n
prăpădenie	f
plenitudine	f
fragă-tătărească	f
dârdâit	n
urda-vacii	f
preromantism	n
semnificativitate	f
intercalaţie	f
oicumena	f
sădit	n
volvox	m
imblătit	n
cvasiunanimitate	f
aventurin	n
etiologie	f
blastopor	m
erodabilitate	f
megapir	n
mani	m
stupitul-cucului	m
panislamism	n
nonviolenţă	f
elutriere	f
negritudine	f
grafică	f
discheratoză	f
finanţe	f
biochimie	f
ficţionalism	n
patos	n
agrochimie	f
pervibrare	f
amenitate	f
înălbit	n
stibiu	n
mană	f
biogeochimie	f
nativism	n
ficomicete	f
exeat	n
cromometrie	f
metalofizică	f
poeticitate	f
ofiolatrie	f
rodul-pământului	n
microfaună	f
cacolalie	f
deşosare	f
decarbonatare	f
reexpotare	f
ascetism	n
zoantropie	f
dumnezeie	f
lichelism	n
diremţiune	f
dogoreală	f
zoocenologie	f
yiang-yiang	n
fitologie	f
macromicete	f
angelică	f
liaze	f
isatină	f
leprologie	f
pluralism	n
caramelaj	n
alterabilitate	f
metalocromie	f
astrometrie	f
ambaras	n
potasă	f
stupărit	n
gibbsit	n
fisibilitate	f
varus	n
mahmurie	f
atentism	n
carenare	f
repugnanţă	f
prasem	n
târgoveţime	f
vanilocviu	n
ofiologie	f
mandala	f
catolicizare	f
cornul-secarei	n
călcat	n
piretru	m
gustărică	f
colţunul-popii	m
borism	n
peştele-lui-Solomon	m
largo	n
lactalbumină	f
lobbyism	n
belonofobie	f
colaboraţionism	n
xenofonie	f
fluorimetrie	f
indivizibilitate	f
pilorism	n
doi-fraţi	m
trinitate	f
iamă	f
onerozitate	f
hârşâit	n
pudlaj	n
amprentare	f
borviz	n
regulaţie	f
japanologie	f
interdependenţă	f
paupertate	f
cineamatorism	n
cinste	f
scat	n
papucă	m
clămpănire	f
teamăt	n
stadial	n
celolână	f
somnilocvie	f
dezghiocat	n
negritură	f
pustnicire	f
otrăţel-de-apă	m
hurtă	f
cioareci	m
discutare	f
brio	n
scofală	f
serpentin	n
gândac-negru	m
iranistică	f
bunăstare	f
radiofosfor	n
hidrodinamică	f
fumarază	f
etuvare	f
genol	n
eroicitate	f
hipofagie	f
zlac	m
xeromorfism	n
anglofilie	f
teras	m
agogică	f
croazea	f
manco	n
completitudine	f
miniaturistică	f
risolă	f
adolescentinism	n
alestâncă	f
sinologie	f
ampex	n
integrand	n
şifonat	n
radiopatologie	f
flexibilitate	f
lentitudine	f
reproductivitate	f
înjugat	n
agresionare	f
păzit	n
hungaristică	f
alelomorfism	n
înrăire	f
lipovenime	f
organogeneză	f
ieşit	n
tristearină	f
bromoform	n
şmuţtitlu	n
comicitate	f
maruflare	f
polimerism	n
necinste	f
microsoft	n
cruiser	n
epanodiu	n
bradipsihie	f
desulfitare	f
afotometrie	f
prehensiune	f
interpsihologie	f
neofreudism	n
semifond	n
neon	n
tonografie	f
banking	n
turnat	n
jerboa	m
paleopedologie	f
agrografie	f
modru	n
arheocultură	f
fermiu	n
crepsatin	n
animare	f
litotamniu	n
bucsău	m
modicitate	f
ranversabilitate	f
oreximanie	f
autarhism	n
estromanie	f
aritmologie	f
tridimit	n
gadiforme	n
meloe	f
congiu	n
ilizibilitate	f
forjabilitate	f
deport	n
impuberitate	f
durat	n
duran	n
raznociţi	m
şplit	n
clinofilie	f
agrogeologie	f
plecate	n
civilie	f
rabie	f
loialism	n
smaltină	f
gimcană	f
doctorantură	f
autodizolvare	f
mixomatoză	f
praseodim	n
laba-ursului-roşie	f
reflexometrie	f
incompresibilitate	f
vulcanocarst	n
neptuniu	n
bacteriostază	f
adiaforie	f
fandem	n
mutabilitate	f
stilistică	f
practicism	n
girare	f
vioriu	n
marinărie	f
actinide	n
gadide	n
adragant	n
odos	m
acustică	f
ortopsihologie	f
pseudolatinism	n
pedofobie	f
mocănime	f
hobanare	f
proteitate	f
plutărie	f
consubstanţialism	n
prevestit	n
tectită	f
pâinea-porcului	f
busuioc	n
ut	m
lesbianism	n
dezancolare	f
metalotermie	f
jintiţă	f
gemut	n
gutieră	f
sifilomanie	f
metaldehidă	f
cavalerime	f
fixing	n
linge-blide	m
westfalian	n
plasmodesme	f
anilism	n
soldăţime	f
erectilitate	f
varoră	f
insensibilitate	f
zgârie-brânză	f
unionism	n
treti-logofăt	m
nosemoză	f
kinetografie	f
diafanoscopie	f
acutumanţă	f
păduchele-calului	m
anglistică	f
seminomadism	n
oniromanţie	f
cheiaj	n
aerodesant	n
clinomanie	f
dezobişnuire	f
darwinism	n
andaluzit	n
hematoporfirină	f
passacaglia	f
jacquerie	f
rotoţele-albe	f
gatopard	n
ienicerime	f
droghet	n
statică	f
barimetrie	f
însingurare	f
decurgere	f
microcarieră	f
igienă	f
magnetostatică	f
ornitogeografie	f
ocheşele	f
noneu	n
neurism	n
centauromahie	f
biomasă	f
microchirurgie	f
autecologie	f
fumegai	n
rodologie	f
oxigen	n
ginecografie	f
electrocăldură	f
romergan	n
dictando	n
empatie	f
pocăire	f
flogistic	n
dantologie	f
piromorfism	n
izocronism	n
juridicitate	f
radioecologie	f
rusistică	f
afectibilitate	f
arăpime	f
hipnagog	n
balanografie	f
vasopresină	f
uncropeală	f
siliciu	n
piroliză	f
roburit	n
tectologie	f
mimografie	f
alergoză	f
aramaică	f
artificialism	n
ceruză	f
autoaglomerare	f
încadratură	f
aerografie	f
dialectică	f
ştir	m
radicalitate	f
rânchezat	n
stelit	n
genecologie	f
cooperatism	n
lila	m
seninătate	f
distocie	f
fidea	f
imagologie	f
fariseism	n
bolometrie	f
scatofagie	f
bătrânime	f
lepidopterologie	f
piscuit	n
ebarbare	f
economism	n
vexilologie	f
zoo	n
criterium	n
atletism	n
chinaldină	f
aval	n
post-scriptum	n
invidiere	f
ingenuitate	f
morfopsihologie	f
nefrit	n
paleofitografie	f
lipidemie	f
sărit	n
fermentat	n
alodialitate	f
răzbun	n
impopularitate	f
nosografie	f
catabolism	n
microbiosferă	f
lactogeneză	f
electrometalurgie	f
spectacologie	f
ucu	m
haplotip	n
fitoecologie	f
facticitate	f
craniometrie	f
mizantropie	f
multiplexare	f
răriţat	n
nemâncare	f
postulantism	n
râsul-pădurii	m
anizometropie	f
aborigenitate	f
marcofilie	f
corotip	n
concretitate	f
dactiliografie	f
pragmatică	f
pisat	n
electoralism	n
difuzionism	n
lupus	n
roşeaţă	f
ilmenit	n
calcografie	f
tahifagie	f
biogeneză	f
răşluire	f
cupelaţie	f
tagete	f
imanentism	n
gălbejeală	f
afrazie	f
onomasiologie	f
coleire	f
filantropism	m
comor	n
prestanţă	f
mascaret	n
armare	f
bandare	f
pangeneză	f
ilegitimitate	f
tataie	m
centrism	n
banco	n
potrivit	n
mandea	m
şchiopenie	f
epinefrină	f
astrospectrografie	f
baptism	n
perperit	n
kainit	n
mărinimie	f
aperceptibilitate	f
tendenţiozitate	f
radioservice	n
tolerantism	n
sarmată	f
eruptivism	n
miocen	n
divorţalitate	f
cian	n
necompatibilitate	f
pocănit	n
cronometrie	f
stafilococie	f
imperforaţie	f
sexualism	n
siderografie	f
chiolbaşi	m
steatopigie	f
sturionicultură	f
rememoraţie	f
necton	n
înclichetare	f
melenă	f
conchifere	f
hasmaţuchi	m
ala-bala	f
algie	f
faradoterapie	f
compatibilizare	f
coada-vulpii	f
miserere	n
gatism	n
dezvăţ	n
aleuronă	f
plutonite	f
recuperabilitate	f
perminvar	n
babaie	m
duplicaţie	f
monosemie	f
erotologie	f
salmonicultură	f
referenţialitate	f
lotrit	n
spontaneism	n
teleonimie	f
anafură	f
trinitrină	f
spiritism	n
teleeducaţie	f
capnometrie	f
antiromânism	n
adio	n
vitalism	n
beteală	f
salol	m
fanerofite	f
trândăvit	n
merstrom	n
hemodinamică	f
slavomanie	f
lubricitate	f
renume	n
bagatelizare	f
hemifonie	f
anaciditate	f
crenoterapie	f
mongolistică	f
gemelologie	f
pluridisciplinaritate	f
falangism	n
corpolenţă	f
barofobie	f
măicuşoară	f
epicurism	n
pivnicerit	n
alcalimetrie	f
germănar	m
necromanţie	f
deltaplanism	n
brizură	f
streptomicină	f
sciografie	f
mutualitate	f
acceptabilitate	f
motilitate	f
persiflaj	n
picat	n
mikado	m
acupunctură	f
gazometrie	f
orgasm	n
recultivare	f
autocnips	n
diamanticale	f
rahiopatie	f
parazitism	n
microchimie	f
pasărea-cânepei	f
legumărie	f
miomalacie	f
confitare	f
forţaj	n
tenişi	m
samariu	n
taulă	f
vandabilitate	f
scorching	m
veselă	f
geochimie	f
Capul-lui-Adam	n
mutaţionism	n
şimi	n
năvădit	n
natalitate	f
iveală	f
covering	n
germanofobie	f
entomofagie	f
prefiltrare	f
cinemascop	n
perintrol	n
biunivocitate	f
geomecanică	f
terme	f
reactivitate	f
pinxit	n
bras	n
egofobie	f
electrotraumatism	n
grafit	n
nonexistenţă	f
durcisare	f
macedoromână	f
gablu	n
eteronomie	f
pituliş	n
cistoide	n
bucelare	f
desatelizare	f
bancocraţie	f
botriocefaloză	f
bazidii	f
stilometrie	f
hristoitie	f
ştiucă-de-mare	f
galvanotropism	n
ideologizare	f
prurit	n
perditanţă	f
melofobie	f
autohtonism	n
inconfort	n
culbutare	f
pseudocuadrofonie	f
chintesenţiere	f
odisee	f
pindarism	n
stenozare	f
bismut	n
prăsit	n
cervix	n
unilateralitate	f
boare	f
futurologie	f
gelisol	n
austenitizare	f
surdopsihologie	f
catafazie	f
lemn-dulce	n
navigabilizare	f
limfogranulomatoză	f
gigantografie	f
situaţie-limită	f
dogoare	f
fermaj	n
irevocabilitate	f
afemie	f
coran	n
fictivitate	f
bumbăcel	n
partenogamie	f
colhoznicism	n
deplinătate	f
didelfi	m
ole	n
fitocenologie	f
etanşeizare	f
coruptibilitate	f
eterogeneză	f
bicamerism	n
ginecopatie	f
seguidilla	f
neerlandeză	f
grafometrie	f
premagnetizare	f
teozofie	f
ecoetologie	f
piuare	f
acaju	m
suber	n
eleganţă	f
pederastie	f
macabe	n
stolerie	f
strofism	n
coacervaţie	f
taylorism	n
neodarvinism	n
tuse	f
muscarină	f
izbelişte	f
anafront	n
saliretină	f
ireductibilitate	f
bulgară	f
miopism	n
zumaricale	f
ciloză	f
răcuşcă	f
emetic	n
zeolitizare	f
varice	f
claustroman	m
zootehnie	f
completivitate	f
polizat	n
dolihocefalie	f
educabilitate	f
accesibilitate	f
magnetooptică	f
kiselgur	n
aerobiologie	f
polimorfism	n
prova	f
malonestitate	f
apersonalizaţie	f
necuprins	n
rabiţ	n
orientalistică	f
intersexualitate	f
unicitate	f
paludometrie	f
coordinare	f
hitită	f
apotropism	n
carpogeneză	f
ocultistică	f
stiplex	n
cistotomie	f
farniente	n
harabagie	f
oxibioză	f
etimologism	n
orhiotomie	f
interdisciplinaritate	f
septuor	n
acrilonitril	m
miscellanea	n
expansivitate	f
antiteticitate	f
eugenism	n
cercetăşie	f
fascizare	f
social-democratism	n
fangoterapie	f
fritaj	n
mambo	n
turbificare	f
elastometrie	f
pedestritate	f
falern	n
antitrinitarism	n
fervoare	f
carp	n
pedimentare	f
acetonurie	f
ceramologie	f
blândeţe	f
şale	f
sârg	n
subliniat	n
keynesism	n
omiletică	f
naturaleţe	f
ecuator	n
spasmofemie	f
biometeorologie	f
omenire	f
aluminiu	n
aluminit	n
mahdism	n
profesionalism	n
inexigibilitate	f
zooterapie	f
latorfian	n
microsociologie	f
hidrotehnică	f
torticolis	n
danian	n
ginandrie	f
elastocinetică	f
alergologie	f
elocvenţă	f
teleradioscopie	f
poligonometrie	f
citofiziologie	f
sugestibilitate	f
biblistică	f
molia-stupilor	f
răzeşime	f
donatism	n
hipertrofiere	f
neostalinism	n
excizare	f
bucraniu	n
electroradiologie	f
fourierism	n
incapacitate	f
solidaritate	f
proxenetism	n
flegmatism	n
frigidarium	n
degelificare	f
anale	f
dezumanizare	f
impetuozitate	f
fixism	n
plinire	f
înmurgit	n
botanică	f
sexologie	f
travertin	n
picaro	m
animatism	n
arhitectonică	f
lignit	n
dentină	f
confortabilitate	f
anosmie	f
eponimie	f
analfabetism	n
difuzibilitate	f
flauş	n
alchină	f
scapăr	n
păiuşcă	f
locomoţie	f
indogermanistică	f
fantascienza	f
ţânţărime	f
anluminură	f
somnoterapie	f
plesimetrie	f
lupulină	f
rodozahar	n
albuminurie	f
nosomanie	f
scorpion-de-baltă	m
perfectism	n
coadnaţie	f
radiat	n
ospitalitate	f
intalie	f
mărgărele	f
foniatrie	f
nu-ştiu-ce	n
saftea	f
nevricale	f
empiriocriticism	n
arabă	f
antipatizare	f
virglorian	n
scelerateţe	f
borghis	n
diversionism	n
vărat	n
pacificare	f
arăcit	n
verticalizare	f
succin	n
platinotipie	f
edenitate	f
tenifug	n
anostie	f
maizenă	f
casone	n
decrosaj	n
taxologie	f
răpciugă	f
telecomandare	f
drift	n
peaj	n
dărăcit	n
voluptuozitate	f
macaronism	n
taxodium	m
prolixitate	f
curtenie	f
biofotogeneză	f
telematică	f
hialofagie	f
faurmaur	m
gonioscopie	f
odontoclazie	f
esker	n
galeofobie	f
leucoree	f
filotaxie	f
scâncit	n
structuralism	n
determinism	n
iodism	n
pierzare	f
piperul-lupului	m
fucus	m
paracheratoză	f
revanşism	n
condriom	n
histografie	f
europenism	n
organino	n
decrispare	f
progresivism	n
fluturat	n
desiderată	n
declorurare	f
culturism	n
barbut	n
onicofagie	f
patison	n
suprarealism	n
îngheţare	f
arianism	n
neologismomanie	f
tricomonas	m
cloropren	n
uracil	n
colimaţie	f
dicaster	n
boierime	f
tenaclu	n
microcefalie	f
herpetologie	f
retroacţiune	f
helveţian	n
lemn-câinesc	n
pântecare	f
inefabilitate	f
românofobie	f
grizumetrie	f
lactobioză	f
zemoşire	f
unidimensionare	f
discreditare	f
topoclimatologie	f
astâmpărare	f
fenolftaleină	f
regenerescenţă	f
aminoacidemie	f
protozoologie	f
codoşie	f
imperiozitate	f
neneacă	f
costoboci	m
imposibil	n
râia-munţilor	f
autenticizare	f
palma-pământului	f
virescenţă	f
azuriu	n
azurit	n
ascetică	f
odontogeneză	f
urdă	f
biocibernetică	f
actinografie	f
galiu	n
laba-mâţei	f
angelism	n
koala	f
muscă-beţivă	f
expansionism	n
competitivitate	f
maca	f
retorică	f
antobiologie	f
rotunjeală	f
scăpătat	n
burgraviat	n
derulat	n
enantioză	f
bantustanizare	f
abstracţionism	n
paranoia	f
buluceală	f
abiologie	f
justiţie	f
ofism	n
stranietate	f
pediluviu	n
păgânime	f
transputer	n
mefitism	n
zoomorfism	n
fălnicie	f
viniplast	n
feromagnetism	n
neopozitivism	n
bulgur	n
căpuş	n
canabină	f
numen	n
pluviozitate	f
cristalometrie	f
cenologie	f
sorboză	f
balistică	f
matronism	n
tripaflavină	f
disoluţie	f
cantal	n
lalaţie	f
asociativitate	f
pirogalol	m
manilovism	n
melisofobie	f
decalcomanie	f
silvologie	f
bikini	n
prezentism	n
apăraie	f
portocaliu	n
externalitate	f
dezdoire	f
algologie	f
zeft	n
tectonosferă	f
ceacşiri	m
glodăraie	f
polemism	n
târât	n
deontologie	f
complexitate	f
vaginopatie	f
bromhidroză	f
oleofilizare	f
echiprobabilism	n
gama	f
mistică	f
dimorfism	n
convenţionalitate	f
curieterapie	f
pop-art	n
sociologie	f
techneţiu	n
crisoterapie	f
ramoliţie	f
dibol	n
înfrigurare	f
colţunii-popii	m
apelativizare	f
cinecromie	f
drob-de-munte	m
ofuscare	f
călibilitate	f
labializare	f
nesaţ	n
magneziu	n
cofeturi	n
distractivitate	f
hohotit	n
hares	n
ultramodernism	n
zestre	f
minigolf	n
ţopăit	n
rigurozitate	f
păcurărit	n
jainism	n
epigeneză	f
farmacocinetică	f
neagră-moale	f
siguritate	f
guarani	n
schibob	n
radiotehnică	f
imperturbabilitate	f
telepedagogie	f
rufianism	n
coeducaţie	f
asesorat	n
calorificare	f
diatecă	f
avântare	f
nevrozism	n
celtism	n
calcozină	f
peridot	n
latirism	n
acropatologie	f
rebonificaţie	f
vorland	n
obligativitate	f
afabilitate	f
ceatal	n
anticomunism	n
ornitomelologie	f
hipsofilă	f
beletristică	f
dăngănit	n
canale	f
simultaneitate	f
diaton	n
arheoastronomie	f
secerar	m
catarism	n
reconfort	n
psihopatologie	f
liber-profesionistă	f
conaţie	f
ciocofleandură	f
sabinism	n
rudişti	m
bazionim	n
fitotehnie	f
hidromorfometrie	f
chimie	f
ataxofobie	f
telecinematografie	f
rezilienţă	f
rotofoto	n
celsit	n
gâdilat	n
manumisiune	f
eucaliptol	m
cianoză	f
monosexualitate	f
indocilitate	f
fertilitate	f
biofizic	n
mătasea-broaştei	f
federvais	n
limba-mielului	f
mineralogie	f
permeabilizare	f
behaism	n
papă-tot	m
galomanie	f
bidimensionalitate	f
wofatit	n
odăjdii	f
lipiodol	n
anastomozare	f
xantogenare	f
glucidogramă	f
glacialitate	f
cromatică	f
irefutabilitate	f
eobiogeneză	f
ţârică	f
interfluviu	n
singeneză	f
genodermatoză	f
trifurcaţie	f
leucobază	f
vampirism	n
cărunteţe	f
uvografie	f
otorinolaringologie	f
bradilalie	f
miruit	n
paleomicologie	f
ocolit	m
urbanistică	f
alcaloză	f
areism	n
urodinie	f
waterpolo	n
gasparcolor	n
leninism	n
mansuetudine	f
concreteţe	f
cercosporioză	f
spusul-dracului	m
scrimă	f
driling	n
virologie	f
termogen	n
periscopicitate	f
evoluţionism	n
capilaroscopie	f
incultură	f
bemberg	n
urotropină	f
coacere	f
rasa	f
coproscleroză	f
angiologie	f
snaip	n
biocorie	f
naturoterapie	f
tehnografie	f
mârlit	n
jovialitate	f
bariu	n
consonantism	n
măcelărit	n
tantra	f
ezoteritate	f
alviţă	f
pehblendă	f
volvulus	n
pauşal	n
febricitate	f
sari	n
kalam	n
îmbiat	n
iarbă-grâuleţ	f
lexicologie	f
fonolit	n
crată	f
omnilateralitate	f
stasiologie	f
fitofenologie	f
ihtiografie	f
pir	m
brevitate	f
adenoidism	n
dormitivitate	f
autocros	n
reniu	n
electroencefalografie	f
meteorografie	f
fitogeografie	f
bipolaritate	f
zvârcol	n
graviditate	f
ping-pong	n
sovpren	n
fumat	n
îndulcire	f
dipodie	f
antropolatrie	f
demonografie	f
concret	n
biomagnetism	n
psoriazis	n
perspectivism	n
centezimă	f
efebologie	f
reconvalescenţă	f
înfundare	f
individualism	n
xenomorfism	n
butargă	f
conceptivitate	f
homoclin	n
chulo	m
diopsid	n
găinuşa-lunii	f
lărgit	n
holism	n
stative	f
afectaţie	f
aerocartografie	f
orientalizare	f
inofensivitate	f
perpendicularitate	f
mass-media	n
degresivitate	f
plugărire	f
neagă	f
substanţialism	n
sfumatură	f
cabernet	n
autografism	n
amhara	m
cratomanie	f
stuficultură	f
pardon	n
românime	f
dârdoră	f
nărtilă	m
gri	m
anizocitoză	f
molia-merelor	f
resupinaţie	f
luminism	n
heterodoxie	f
infailibilitate	f
redibiţie	f
rectiliniaritate	f
coada-raculul	f
dirijism	n
vigoare	f
ortoscopie	f
dolomitizare	f
novatorism	n
constantan	n
propenă	f
hitlerism	n
fecunditate	f
bronhoree	f
morfofiziologie	f
negativism	n
cosmopolitism	n
geognozie	f
prozaism	n
duracid	m
ponderaţie	f
conjugalitate	f
cooperit	n
quick-kola	f
sardanapalism	n
demâncat	n
vitaminoză	f
dismorfologie	f
neaderenţă	f
ferestrică	f
insaţiabilitate	f
purice-de-apă	m
rebotezare	f
brunaj	n
furajerie	f
antrelac	n
citofagie	f
fungi	m
zaratit	n
paraetnologie	f
creaţionism	n
ruralizare	f
sugestivitate	f
corium	n
ancoşă	f
scalimetrie	f
năut	m
calvinism	n
helmintologie	f
irenism	n
melotipie	f
heliografie	f
bernsteinian	m
sida	f
jurnalism	n
eneolitic	n
kenoglosie	f
efluviu	n
pincops	n
arenaria	f
chinoroz	n
confucianism	n
hidropizie	f
rejeton	n
inexpugnabilitate	f
zoocorie	f
cataligee	f
neangajare	f
ronţăit	n
semidoctism	n
aroganţă	f
impersonalitate	f
fitoterapie	f
relaxaţie	f
pălăria-şarpelui	f
navigabilitate	f
speleoterapie	f
pleaşcă	f
panzofie	f
radiate	n
verticilioză	f
metalogeneză	f
tectogeneză	f
fânişor	n
mercede	f
acrime	f
citoplasmă	f
săniat	n
exorcism	n
pirogenare	f
triboelectricitate	f
somnolare	f
maruflu	n
fotbal	n
cărnişoară	f
teritorialitate	f
ypresian	n
infertilitate	f
gingivoragie	f
geomorfogenie	f
creştinare	f
geoecologie	f
ceruzit	n
galenă	f
astrologie	f
eterogeneitate	f
gastrulaţie	f
aerologie	f
amănunţit	n
centumvirat	n
demofobie	f
otuzbir	n
guşa-porumbelului	f
landras	m
descriptivism	n
jemanfişism	n
cerci	m
zburdă	f
neonatologie	f
împrejmuit	n
operaţionalism	n
gelifract	n
parapsihologie	f
călăuzire	f
lagostom	n
calaminare	f
substanţializare	f
triplex	n
cariere	f
animalizare	f
afonie	f
pronie	f
câinie	f
megabrecie	f
secund	n
revizionism	n
amazonit	n
arsenic	n
germanofilie	f
nicroterm	n
sud-est	n
agrozootehnică	f
arhondologie	f
clarviziune	f
coada-cocoşului	f
radiovacanţă	f
excentrism	n
operaţionism	n
alemani	m
dezinvoltură	f
podotehnică	f
constructivitate	f
cazeină	f
sanctus	n
glosografie	f
martirizaţie	f
impresionism	n
regeste	f
cromatare	f
jugărit	n
andrologie	f
hărnicie	f
provenire	f
electrum	n
dezasfaltare	f
meşter-strică	m
mixomicete	f
rihtuit	n
bună-dimineaţa	f
metromanie	f
anormalitate	f
jenă	f
proiectivitate	f
sociabilizare	f
disgravidie	f
cosmocraţie	f
pepelea	m
vede	m
ergopsihiatrie	f
epicitate	f
mieluşei	m
profesionism	n
monumentalitate	f
monofobie	f
ţigănime	f
confesionalism	n
ponderozitate	f
văcălie-de-brad	f
comestibilitate	f
decubit	n
topicalizare	f
brasero	n
politehnizare	f
organonimie	f
tuşică	f
nervozitate	f
sanscrită	f
labilitate	f
escatologie	f
neuropatologie	f
iarbă-neagră	f
proletariat	n
dendrologie	f
agonizare	f
sfincterectomie	f
epidemicitate	f
jintuit	n
contiguitate	f
nefrologie	f
nuncupaţie	f
verism	n
suicidologie	f
bajocian	n
stem	n
multilingvism	n
solvabilitate	f
morescă	f
plebe	f
pantoptoză	f
suprematism	n
tipicitate	f
tocat	n
sfredelul-Rusaliilor	n
plopovăţ	n
scatol	n
pregnanţă	f
hidrogeochimie	f
idiobiologie	f
inconformism	n
manganezit	n
deontologism	n
nostomanie	f
disuasiune	f
adenoviroză	f
băcit	n
periclitate	f
bardor	n
minirugbi	n
potamobotanică	f
bardou	m
monocondil	n
atomicitate	f
shakespearianism	n
mau	n
retractilitate	f
asfodelă	f
cotlete	n
nonconformism	n
zoosemiotică	f
cantabile	n
talc	n
boemă	f
buhai-de-baltă	m
hara-para	f
cabotinism	n
evazionism	n
ceramică	f
dogat	n
autoclavizare	f
hemofobie	f
ivoriu	n
antinomism	n
încins	n
sopor	n
tauromahie	f
wurtzit	n
caustificare	f
sitologie	f
cartografie	f
udăturică	f
bătătorit	n
rusticism	n
gonflant	n
dislexie	f
dislexic	n
orb	n
orc	m
ludian	n
orzişor	n
garanţină	f
fitosociologie	f
magnezie	f
subalimentaţie	f
milino	n
dezgropat	n
pletorism	n
magnezit	n
apersonalizare	f
căldurică	f
surdologie	f
colorism	n
agrobiologie	f
rinalgie	f
diapirism	n
relon	n
imparţialitate	f
neocatolicism	n
zbenguit	n
columbofilie	f
mraniţă	f
magnetosferă	f
lusin	n
cianizare	f
mijeală	f
extremum	n
fiziologie	f
pruină	f
petrolizare	f
rută-sălbatică	f
crimoterapie	f
aţă-de-mare	f
falarică	f
prâslea	m
electrotonus	n
sudamină	f
învăţătorime	f
canicultură	f
molia-porumbului	f
ozonometrie	f
angli	m
otopatie	f
coempţiune	f
utopism	n
supleţe	f
sărăcilă	m
incomoditate	f
neobaroc	n
colagen	n
enurezis	n
conceptualitate	f
laringologie	f
polisemie	f
neseriozitate	f
cacostomie	f
anabaptism	n
acvafobie	f
volei-bal	n
antropozoonoză	f
puritate	f
neotip	m
fălţuire	f
pupa	f
levantinism	n
neotie	f
găsit	n
canarisire	f
homosexualitate	f
doctrinarism	n
stratojet	n
gril	n
tafofobie	f
giraviaţie	f
arnăuţime	f
trăit	n
culanţă	f
corăbiele	f
metageometrism	n
nevăzute	n
dezobstrucţie	f
iahting	n
înghesuire	f
hipermasculizare	f
labru	m
lichenografie	f
somatogenie	f
melilit	n
ecarte	n
ningău	n
mondoeconomie	f
smead	n
trot	n
kaliu	n
încuiat	n
patofiziologie	f
pitting	n
griş	n
bentos	n
ultrasonoscopie	f
asexualitate	f
carpi	m
fonologie	f
echilibristică	f
înnoptare	f
babism	n
masculinism	n
celioscopie	f
osram	n
ouătoare	f
atractivitate	f
exploatare	f
defenestrare	f
criopedologie	f
cazualism	n
laconism	n
stereognozie	f
paos	n
şters	n
mehterbaş	m
simfonism	n
caracterologie	f
pompozitate	f
semipermeabilitate	f
ihtiologie	f
xerofilie	f
pedepsibilitate	f
public	n
policultură	f
sigă	f
contemporaneizare	f
variac	n
tehnicitate	f
dicroism	n
vorbă-lungă	m
diafanometrie	f
transcristalizare	f
pelin-bun	m
deism	n
abiotrofie	f
frizonet	n
termistanţă	f
magnetodielectric	n
pervitină	f
litologie	f
colorabilitate	f
ardoare	f
chimicale	f
statuare	f
frontalitate	f
islandeză	f
digitaţie	f
păcură	f
veronal	n
joncţionare	f
grabă	f
posturalitate	f
rupia	f
voaierism	n
lutişor	n
macrobiotică	f
veleitarism	n
corelativitate	f
obsigă	f
argentotipie	f
carbohidrază	f
ducă-se-pe-pustii	m
fisc	n
sunnism	n
higromorfie	f
victimologie	f
orient	n
nesomn	n
negândite	n
zoizit	n
print	n
prins	n
cognoscibilitate	f
raţionalism	n
noctambulism	n
micropaleontologie	f
ţafandache	m
sonoluminescenţă	f
orzoaică	f
antiperistaltism	n
măgurele	f
radiofizică	f
astrofizică	f
întrajutorare	f
kala-azar	n
drapeu	n
lehm	n
populaţionistică	f
energetică	f
recording	n
săturate	n
litosferă	f
serologie	f
zaharuri	n
pecabilitate	f
formularistică	f
deproletarizare	f
bun-gust	n
glotologie	f
dezvirginare	f
multifuncţionalitate	f
ricercar	n
romanofonie	f
ergoterapie	f
defervescenţă	f
miocard	n
fezabilitate	f
estetizare	f
anhidroză	f
morfinomanie	f
bachelită	f
ochlofobie	f
supunere	f
terorism	n
sill	n
bazileu	m
maturitate	f
şedinţomanie	f
însetoşare	f
ruşinea-fetelor	f
codeină	f
cavalcavia	n
criopatie	f
inamovibilitate	f
viatic	n
sialografie	f
echilibraj	n
proteinoterapie	f
salicilamidă	f
comportamentilism	n
secesionism	n
gravidism	n
pepsi	f
cretacic	n
egotism	n
claustritate	f
electroalimentare	f
otalgie	f
disestezie	f
cosmochimie	f
barotraumatism	n
gai	n
metaetică	f
musculozitate	f
notorietate	f
helmintoscopie	f
zi-lumină	f
lohii	f
meteoropatologie	f
virago	f
yoga	f
koine	f
antipalagă	f
aluviu	n
timie	f
mesmerism	n
decapitalizare	f
deglaciaţie	f
ortoepie	f
potamologie	f
ultramicrochimie	f
metronomie	f
hipism	n
concentrism	n
pescuit	n
alejanţă	f
anizogamie	f
neprevăzut	n
coir	m
palatoplastie	f
lard	n
lari	m
sedimentogeneză	f
înţărcat	n
acribologie	f
drămuire	f
pistol-mitralieră	n
factologie	f
orbilianism	n
etnolingvistică	f
orientabilitate	f
lexic	n
molie-de-albine	f
schiascopie	f
ibum	n
demâncare	f
oseminte	n
aforisticitate	f
cerebromalacie	f
şpăltuit	n
holteie	f
ritologie	f
speobiologie	f
electrogalvanism	n
serafism	n
stratocumulus	m
hiperbolism	n
armeană	f
noologie	f
sabir	n
neobrăzare	f
micropedagogie	f
avionică	f
inulină	f
patogenitate	f
psilomelan	n
morfologism	n
micşorime	f
hieratism	n
biomaterial	n
acidofilie	f
dezbrăcare	f
calicire	f
butaforie	f
lubrifianţă	f
memorialistică	f
bolson	n
neptunism	n
tricofiţie	f
derâdere	f
bacteriemie	f
umanitate	f
cataroi	n
paracazeină	f
barba-împăratului	f
sforac	n
zircon	n
alit	n
aurolit	n
contratipare	f
razmot	n
lama	m
brizanţă	f
somnolenţă	f
rapăn	n
catalepsie	f
bine	n
tolerare	f
ferimagnetism	n
inductotermie	f
senonian	n
floarea-brumei	f
ampicilină	f
decorum	n
homocronie	f
heterogrefă	f
artritism	n
precădere	f
soare-răsare	m
uranite	n
cucernicie	f
termalism	n
eficacitate	f
tactism	n
vademecum	n
chimiotaxie	f
muţire	f
saltaţie	f
luciferină	f
conductibilitate	f
pozitivitate	f
erotopatie	f
smog	n
cancerizare	f
propilenă	f
tabuism	n
hipoglicemie	f
ortomorfie	f
raseologie	f
sinecologie	f
patriarhalism	n
ucraineană	f
previzibilitate	f
azoospermie	f
tantrism	n
isprăvit	n
antropoclimatologie	f
misoginism	n
glodărie	f
enografie	f
frizat	n
culturalitate	f
terminism	n
numerotat	n
ciuboţica-ursului	f
patriarhalizare	f
dodii	f
lipemie	f
gelifracţie	f
taxiterie	f
recursivitate	f
realizabilitate	f
vitalizare	f
crocodilieni	m
uviol	n
gurut	n
pirosferă	f
crimofite	f
vermutizare	f
urzit	n
agresologie	f
găinuşa-popii	f
profesorat	n
industrialism	n
peţit	n
dialogism	n
culpabilitate	f
ureche-tătărească	f
savoare	f
directitate	f
scenotehnică	f
lumaşel	n
biliverdină	f
corporalitate	f
dumnezeire	f
canabism	n
pietroşel-sur	m
monotelism	n
uranină	f
speriat	n
sociolingvistică	f
pattern	n
plastochimie	f
vaccinelă	f
oină	f
rizosferă	f
piroelectricitate	f
transformabilitate	f
cristologie	f
sacerdotism	n
omfalopatie	f
predeterminism	n
orjad	n
diafotie	f
morfografie	f
chelen	n
poinofobie	f
onomastică	f
eredosifilis	n
ramie	f
gerontofilie	f
anticonformism	n
văcărit	n
observanţă	f
ribonuclează	f
legumicultură	f
metilviolet	n
creatologie	f
fitotoxic	n
poligonaţie	f
psihomanţie	f
covelină	f
numerologie	f
pecenegă	f
partenofobie	f
feudalitate	f
electrogravimetrie	f
eugenie	f
paleodendrologie	f
criergie	f
somnambulism	n
chiostro	n
haleală	f
golătate	f
rectalgie	f
digraf	n
arheoetnologie	f
prozaicitate	f
gelivitate	f
hatteria	f
înroşire	f
daija	f
apologizare	f
tanăt	m
adolescenţă	f
caliptră	f
bizantinizare	f
ectromelie	f
izmă	f
eutimie	f
paralelitate	f
clasicism	n
pândit	n
peniţa-bungeacului	f
crinovil	n
geotectonică	f
megacosmos	n
psihofarmacologie	f
morfinism	n
santonian	n
impostaţie	f
hipomanie	f
propicitate	f
rococo	n
anemografie	f
cordiţă	f
etnogenie	f
scăzute	n
deşelat	n
blefaroconjunctivită	f
satirism	n
fonocriminalistică	f
gelinită	f
stenografie	f
electroprelucrare	f
cromatism	n
tipărit	n
reflectivitate	f
leucoplaste	n
fricando	n
paroli	n
seismografie	f
uloragie	f
cinegetică	f
imobilitate	f
catamorfism	n
brevilocvenţă	f
hadefobie	f
energologie	f
microbiologie	f
zmeuriu	n
trimorfism	n
saducheism	n
perlicultură	f
uredinofloră	f
lapoviţă	f
promiscuitate	f
oseină	f
melană	f
apofite	f
cruzeiro	m
bonton	n
apă-neagră	f
chibzuire	f
prostime	f
criometrie	f
mentol	n
entomofobie	f
scoţi	m
ofset	n
glucometrie	f
comsomol	n
tifoză	f
teleficare	f
hormonologie	f
nemurire	f
africanologie	f
acidorezistenţă	f
fanatism	n
integritate	f
nevrotomie	f
psihoterapie	f
strâns	n
smârcâit	n
slugărit	n
endemicitate	f
anonimat	n
crioterapie	f
hafniu	n
donare	f
deviaţionism	n
stenodactilografie	f
cărindar	m
stereometrie	f
prânzit	n
plimbărică	f
ţesere	f
geraniu	m
gheenă	f
nu-mă-uita	f
şoricărime	f
perpetuum	n
înfruptare	f
bruscheţe	f
tehnologism	n
indispensabilitate	f
maleinizare	f
eclat	n
mezolitic	n
icrişoare	f
ebuliometrie	f
vaşete	f
anterofilie	f
balotat	n
misogamie	f
basuto	m
luddism	m
tot	n
crâcnire	f
rutinism	n
autoadministrare	f
vântoaică	f
diabolo	n
ilaritate	f
lactoglobulină	f
magnetoflex	n
quebracho	m
bătut	n
telesport	n
pandanus	m
paliag	n
kerosen	n
fastuozitate	f
alcoolmetrie	f
hidrocinematică	f
farmacografie	f
fotografiat	n
paraformaldehidă	f
sago	n
saga	f
radiu	n
mithraism	n
ospeţime	f
sagu	n
gnomologie	f
vibice	f
dalai-lama	m
cărnicică	f
rotenonă	f
baubau	m
marketizare	f
calcocloroză	f
catgut	n
molie-de-pământ	f
miotonie	f
ogărime	f
rugină-de-baltă	f
masculinizare	f
bunăvoinţă	f
distructivitate	f
enzootie	f
filogeneză	f
ieftinătate	f
geotermie	f
ledeburită	f
antialcoolism	n
heteronomie	f
mersolat	m
ineligibilitate	f
barbarizare	f
zgrunţurozitate	f
butonaj	n
cloroformizare	f
engler	n
skarn	n
duroplast	n
piciorul-caprei	n
scrobit	n
scenaristică	f
marinism	n
sărbezeală	f
aeraulică	f
bacteriurie	f
zoom	n
zoon	m
iremisibilitate	f
arabizare	f
scenologie	f
specific	n
baroforeză	f
damasc	n
sagacitate	f
carenţare	f
menehm	n
circumnavigaţie	f
creatinină	f
tuberculizare	f
lateralitate	f
trigamie	f
storaj	n
cernut	n
sfericitate	f
friulană	f
anarhie	f
universalitate	f
postmodernism	n
disritmicitate	f
antipsoriazis	n
trei-leşeştile	n
panificare	f
aerosoloterapie	f
dopamină	f
biostatistică	f
linicultură	f
oţele	n
serialitate	f
echitabilitate	f
pocnit	n
admisibilitate	f
fotocromografie	f
bathonian	n
zegism	n
beligeranţă	f
lânăriţă	f
eurocomunism	n
cenomanian	n
demonizare	f
monism	n
gravitate	f
triptofan	m
teledetecţie	f
postcombustie	f
rotoheliografie	f
opticitate	f
panamericanism	n
scobit	n
autonomism	n
electroerodare	f
pierzanie	f
jale_de_câmp	f
mezologie	f
laxism	n
bahada	f
imnografie	f
pediatrie	f
bacilifobie	f
floarea-reginei	f
dialectitate	f
registraţie	f
epigastralgie	f
oblicitate	f
stereoizomerie	f
stufăraie	f
hapax	n
capie	f
capia	m
gramaj	n
surzilă	m
transaminare	f
umlaut	n
nevolnicie	f
singularism	n
militantism	n
axis	n
calcemie	f
focometrie	f
fascism	n
carcinologie	f
eudiometrie	f
jertfire	f
alergografie	f
pseudoştiinţă	f
podit	n
fabricare	f
norie	f
botriomicoză	f
puştism	n
aprilie	m
colectomie	f
duramenificare	f
urechea-babei	f
maestrichtian	n
magmatism	n
neantizare	f
pasionalism	n
spinul-cerbului	m
cafeteria	f
progresivitate	f
lamelare	f
lazulit	n
falsitate	f
dosnică-galbenă	f
talmeş-balmeş	n
sialitizare	f
carbolineum	n
neurooftalmologie	f
telemetrare	f
sgraffito	n
alah	m
cuaternar	n
electronituire	f
pagofobie	f
apuntizare	f
cateterism	n
dislogie	f
fagofobie	f
holoedrie	f
paleoecologie	f
frunză-de-potcă	f
guvernamentalism	n
gură-cască	m
docimologie	f
izoanaliză	f
spumegai	n
cardiocel	n
metalogenie	f
moldavit	n
arioso	n
oceanografie	f
deset	n
simbolică	f
farmacodinamie	f
cardinalat	n
paludologie	f
dioptrică	f
fenomenalizare	f
kungurian	n
acerateriu	m
alunele	f
osmologie	f
sexualizare	f
crionică	f
postulaţie	f
coledoc	n
adezivitate	f
ciocoime	f
biomecanică	f
deliteraturizare	f
mezozoic	n
peristaltism	n
carnian	n
celaperm	n
vest	n
nitroglicerină	f
doricism	n
peşte-auriu	m
hipoaciditate	f
oscitanţă	f
galban	n
clătit	n
brahă	f
cremnofobie	f
htonism	n
hidroclimatologie	f
crabare	f
agrominim	n
rapiditate	f
zegras	n
arhivoeconomie	f
stenos	n
tren-fulger	n
avariţie	f
arpagic	n
coton	n
poliacrilonitril	m
tanti	f
treierare	f
conclusum	n
apocalips	n
galoşare	f
telemea	f
corniţe	n
leul-furnicilor	m
alumin	n
turnus	n
izotopie	f
neconformism	n
neproliferare	f
floarea-Paştelui	f
izgonire	f
hidrochimie	f
inacceptare	f
cornalină	f
ferotipie	f
anglomanie	f
majorat	n
nonşalanţă	f
paleoantropologie	f
parageuzie	f
servilitate	f
scara-pisicii	f
directitudine	f
răsărire	f
oţel-balot	n
hiperexcitabilitate	f
bacterioriză	f
ortogonalitate	f
mezofil	n
tuţorism	n
paleohistologie	f
electroosmoză	f
colocvialism	n
alocentrism	n
sperieţi	m
nefologie	f
baladizare	f
rândunica-Domnului	f
montanologie	f
cronaxie	f
recidivism	n
algebră	f
electrocaustică	f
antitotalitarism	n
venerologie	f
hiperparatiroidism	n
disprosiu	n
zootomie	f
alterit	n
limfogeneză	f
tabacioc	n
consol	n
epistemă	f
sedentarism	n
civilizare	f
azbestoză	f
pneumatoliză	f
teandrie	f
geotactism	n
probabilism	n
eden	n
transcendenţă	f
parazitologie	f
encefaloscopie	f
îngreţoşare	f
raţionalitate	f
satanism	n
iraţionalitate	f
tagă	f
redivizare	f
cineanimaţie	f
romancero	n
bombănit	n
colecistectomie	f
certozină	f
înturnat	n
cvadrisilat	n
peripateticism	n
elinvar	n
repusare	f
trecut	n
eumenide	f
periodologie	f
iotacism	n
cromatologie	f
neogreacă	f
glagore	f
mirmecologie	f
agatârşi	m
zuluşi	m
trilateraţie	f
homilofobie	f
anticreştinism	n
ftiziologie	f
neofilie	f
geofotogrammetrie	f
şnurceramică	f
cloretan	m
eterogenitate	f
meteorofobie	f
adonis	m
lâncezire	f
jocularitate	f
răsuflătoarea-pământului	f
anistoricitate	f
idoneism	n
tândală	m
pantonomie	f
termoliză	f
rusticitate	f
ipsos	n
panromânism	n
nicotină	f
donă	f
ienibahar	n
îndrăgostire	f
dodecafonism	n
calistenie	f
stolzit	n
relaţionism	n
neurastenizare	f
polarizabilitate	f
exclusivism	n
bun-plac	n
burlăcie	f
carierism	n
taşism	n
şablonism	n
asudare	f
locupletare	f
gura-lupului	f
echiplanaţie	f
mutitate	f
mangold	m
albescenţă	f
balneofizioterapie	f
latir	m
talasomanie	f
turboreacţie	f
încăierătură	f
compur	n
ergogeneză	f
psihotehnică	f
italienistică	f
haplea	m
gerontofobie	f
carpologie	f
cantabri	m
celuloid	n
creatină	f
termoelasticitate	f
devoluţiune	f
estetică	f
ferfeniţit	n
structuralistică	f
nielare	f
mândrire	f
vemelian	n
dilaceraţie	f
hilea	f
ceamur	n
tolănire	f
favorabilitate	f
empirism	n
balneogeologie	f
etnocultură	f
particularism	n
pârţag	n
germanitate	f
lactariu	n
perifiton	n
diorism	n
traductologie	f
dextrinizare	f
molaritate	f
proporţii	f
organotropism	n
terotehnică	f
cârpit	n
trei-păzeşte	n
energetism	n
boracit	n
sedentaritate	f
ariditate	f
hipernutriţie	f
seniorat	n
muncitorime	f
bracare	f
înţepeneală	f
gătit	n
valină	f
ciclopentan	m
autoadaptare	f
tabuizare	f
andragogie	f
panpsihism	n
fetru	n
delta	m
distomatoză	f
conectică	f
eudemonism	n
nesiguranţă	f
graham	n
informatică	f
prădat	n
sutra	f
geonomie	f
precaritate	f
etnogenealogie	f
alamină	f
fucoide	f
cosmonautică	f
accidentalitate	f
calomel	n
inaccesibilitate	f
morfogeneză	f
păscut	n
diapozitivare	f
fotofonie	f
reeşalonare	f
carbogen	n
imortalitate	f
francofobie	f
pneumatologie	f
importanţă	f
păhărnicie	f
psihometrie	f
inexorabilitate	f
providenţă	f
vegetarianism	n
antifonie	f
zoopsihologie	f
cinetică	f
cavilieră	f
maleficitate	f
şoricime	f
deionizare	f
bilicultură	f
pruncie	f
grifonaj	n
giugiulit	n
gabardină	f
tribalism	n
şoptit	n
impregnabilitate	f
koblenzian	n
naţionalism	n
sir	m
ihtiocol	n
caloricitate	f
reflexibilitate	f
sif	n
sin	m
ciobănit	n
carbonatare	f
mutualism	n
comprehensivitate	f
băut	n
juglandă	f
criogenie	f
reomorfism	n
imaterializare	f
primaritate	f
biocor	n
pseudodipter	n
urbanitate	f
lalopatie	f
compositum	n
tetanie	f
indehiscenţă	f
selecţiuni	f
biocultură	f
ontogeneză	f
hiponimie	f
concerto-grosso	n
nerăsuflate	n
mi	m
contractualism	n
respir	n
anşoa	f
aşchiabilitate	f
pelincile-Domnului	f
ţâţa-vacii	f
boit	n
sial	n
tenacitate	f
prestrib	n
oarecică	f
blancare	f
broşaj	n
terilenă	f
magnico	n
colodionare	f
proligeraţie	f
zupăit	n
fetească	f
citogerontologie	f
joacă	f
vârtoşie	f
dezexcitare	f
balcanologie	f
dilecţiune	f
mondoviziune	f
combo	n
combe	f
votum	n
litotipografie	f
valabilizare	f
ivire	f
rupelian	n
celerimetrie	f
arsen	n
manevrabilitate	f
tutunărit	n
galalit	n
odinofobie	f
sanidină	f
aerodinamică	f
titanism	n
zinc	n
explozivitate	f
oviparitate	f
înfundat	n
hindi	n
autocratism	n
tonică	f
sămănătorism	n
cibernetică	f
indeterminism	n
giuvaiericale	f
aflare	f
inişor-de-alior	m
bodoni	n
biocomunicaţie	f
cinz	n
inch	m
suborizont	n
imbricare	f
destoinicie	f
toponomastică	f
devirilizare	f
biologism	n
îmbunare	f
speciologie	f
sulfonă	f
circă	f
paleogen	n
cineradiografie	f
rubidiu	n
epirologie	f
personalia	f
calcopirită	f
ermetism	n
sanidinit	n
atotputernicie	f
sfumato	n
fenilhidrazină	f
istorism	n
metiluree	f
găinuşă-de-seară	f
imuabilitate	f
irlandeză	f
evitabilitate	f
amenoree	f
exobiologie	f
kaliemie	f
retrognatism	n
mendelism	n
meteorism	n
rătăcit	n
fuzibilitate	f
citozoologie	f
electrotipie	f
colergang	n
electrostricţiune	f
perseveraţie	f
şarpe-orb	m
belcanto	n
pronosport	n
colegialitate	f
onomatofobie	f
interschimbabilitate	f
enantiomorfism	n
voracitate	f
geobotanică	f
rutilism	n
biotină	f
împrietenire	f
disponendă	f
gipsologie	f
pelorie	f
deloialitate	f
urale	n
creofagie	f
tăiculiţă	m
siloxicon	n
durşus	m
jihad	n
cinabru	n
loro	n
lori	m
araneologie	f
amor-propriu	n
cardiomegalie	f
onorabilitate	f
sineluit	n
imaturitate	f
aeromecanică	f
seriozitate	f
bacon	n
trecento	n
ciriş	n
ecometrie	f
ignoranţă	f
antipapism	n
retardaţie	f
folcloristică	f
matetică	f
fitogeneză	f
monşer	m
spunglas	n
adipozitate	f
ebonită	f
plastbeton	n
deşocare	f
radioşcoală	f
tihnire	f
rotit	n
electroscopie	f
tracomanie	f
aur	n
fachirism	m
pasant	n
calfatare	f
mişunare	f
concretitudine	f
carioca	f
amofosca	n
polietilenă	f
găinuşă-galbenă	f
spoliariu	n
diapedeză	f
azotemie	f
robotehnică	f
chimion	m
blastogeneză	f
granulometrie	f
agrozootehnie	f
roylon	n
autohtonitate	f
ergocalciferol	m
scăpărat	n
chica-voinicului	f
cicloparafină	f
tehnopsihologie	f
toxoplasmoză	f
tuaregi	m
reconstrucţionism	n
răgilat	n
zadar	n
arhivologie	f
erozivitate	f
educaţie	f
paleobiologie	f
doxă	f
neocolonialism	n
hahniu	n
hermafroditism	n
imunopolizaharide	f
septembrie	m
dentistică	f
sincronologie	f
genialitate	f
cap-de-mort	n
plastic	n
pompierism	n
heptalon	n
melanhidroză	f
superacril	n
ruminare	f
semiopacitate	f
napalm	n
asiriologie	f
boston	n
fizicalism	n
scămoşat	n
policondensare	f
concordie	f
avanfosă	f
faste	f
dinatron	n
fărâmat	n
subiectivizare	f
apriorism	n
locvacitate	f
cârmâz	n
heliologie	f
insondabilitate	f
uranografie	f
halomegalie	f
somatometrie	f
melogran	m
buraj	n
pilozitate	f
mensuralism	n
cupal	n
tungsten	n
noradrenalină	f
omotaxie	f
surescitabilitate	f
gomina	f
izotipie	f
acromatism	n
neoplasticism	n
ostăşie	f
crinieră	f
miorcăit	n
octuor	n
televiziune	f
anafrodizie	f
termocinetică	f
higroscopie	f
înlemnire	f
calamus	n
înjugare	f
ergotism	n
flăcărie	f
întemeiere	f
gamofilie	f
diabetologie	f
input	n
silimanit	n
eritroză	f
temperare	f
geoid	n
trândăvie	f
deboşare	f
memorii	n
fenometrie	f
agranulocitoză	f
boehmit	n
neopren	n
arhaic	n
suprasaturaţie	f
înăsprire	f
gâdilici	n
chiuită	f
încăierat	n
tiriac	n
tropopauză	f
fotogrammetrie	f
perseide	f
evirare	f
pneumografie	f
parlamentarism	n
friz	n
cal-de-mare	m
condiţionalism	n
paludrină	f
sensibil	n
fructoză	f
decontextualizare	f
rusificare	f
geomedicină	f
trematologie	f
zaharimetrie	f
venustate	f
langoare	f
egolatrie	f
candel	n
telefonat	n
monopson	n
anestezie	f
levitaţie	f
dietetică	f
occidentalizare	f
balcanistică	f
răsfoit	n
verticalitate	f
asterism	n
benzpiren	n
dunst	n
melanurie	f
durox	n
filantropinism	n
magism	n
blasfemie	f
răcit	n
gliptografie	f
termoenergetică	f
somatopedie	f
fiabilitate	f
trituraţie	f
remora	f
petrosin	n
robotă	f
pleavă	f
acrofonie	f
electroanestezie	f
labarum	n
trucă	f
antiintelectualism	n
coordinanţă	f
chinuială	f
bigi-bigi	n
înstrăinat	n
staţionat	n
cloropicrină	f
parodontopatie	f
cardialgie	f
leucoplazie	f
curiosa	m
panlogism	n
bibliofilie	f
clitoris	n
humorescă	f
năgară	f
carus	n
decembrie	m
paginatură	f
calaican	n
vietnameză	f
diletantism	n
păstrare	f
devitrificare	f
bronhometrie	f
tartufism	n
biblioteconomie	f
fugacitate	f
învecinare	f
teleinformatică	f
şlam	n
cavalerism	n
nerecunoştinţă	f
tocare	f
contrarietate	f
atemporalitate	f
platformare	f
atramentare	f
determinat	n
planorbis	m
grafofobie	f
saţ	n
concertino	n
polisemantism	n
ergometrie	f
flagranţă	f
puni	m
bardeziu	n
histopatologie	f
religiozitate	f
molibdit	n
cuniculicultură	f
încolţire	f
păduche-de-lemn	m
cuaga	m
veracitate	f
vehemenţă	f
flexibilizare	f
vechime	f
curara	f
esenţializare	f
benzopirină	f
gaiacol	n
tezism	n
saponarie	f
piretoterapie	f
insolvenţă	f
capul-şarpelui	n
etiopatogenie	f
transformaţionalism	n
geolingvistică	f
opacitate	f
măseaua-ciutei	f
cecitate	f
vaca-Domnului	f
maoism	n
igniţie	f
radiochimie	f
revier	n
măsălar	m
redizolvare	f
subsidiaritate	f
primigeste	f
genere	n
palingeneză	f
ciclohexanol	m
sforăit	n
lactamă	f
înotat	n
calvados	n
psihologism	n
tantocronism	n
pseudodemenţă	f
spart	n
scorpie-de-mare	f
mortezat	n
bandceramică	f
marcografie	f
portabilitate	f
secuime	f
rutil	n
sardiu	n
bioastronautică	f
irani	m
autocălire	f
cloromicetină	f
cutezare	f
cristalotomie	f
revoluţionarism	n
fiziopatie	f
corporatism	n
calaminaj	n
papură-rotundă	f
blau	n
crichet	n
prisoase	n
aerare	f
glucoză	f
piafe	m
pubertate	f
pavogad	n
monofizitism	n
iscusime	f
mică	f
indianism	n
devanagari	f
heliocromie	f
urlaţi	m
rădăcină-de-lingoare	f
tătucuţă	m
fluorină	f
dacism	n
picuşor	n
motobal	n
codaj	n
muzeografie	f
orizontalism	n
elicitate	f
ţeţe	f
localism	n
nichel	n
carbonado	n
hidalgo	m
prodigiozitate	f
majarcă	f
gaibe	f
alendelon	n
albiciune	f
şifonabilitate	f
europocentrism	n
naturalizaţie	f
aplicabilitate	f
albaspină	f
acţionariat	n
insociabilitate	f
colindat	n
mitoză	f
menopauză	f
medaliere	f
falansterianism	n
traista-ciobanului	f
indan	n
ulcerare	f
vilit	n
rea-credinţă	f
marşare	f
bombament	n
ghebe	f
propolis	n
lusitanian	n
trigonometrie	f
mărită-mă-mamă	f
iunie	m
întuneric	n
gimnofobie	f
malţ	n
profitabilitate	f
ascită	f
pedotehnie	f
floarea-Paştilor	f
odontografie	f
cască-gură	m
văz	n
mentalism	n
aglutinină	f
termogeneză	f
hindustană	f
restringent	n
degeţel-roşu	n
supraconductibilitate	f
pluridimensionalitate	f
ferice	f
primăvărat	n
viu	n
zaharicale	f
paradoxie	f
bărcuit	n
heroinomanie	f
caracaşicuri	n
armatan	n
înec	n
malm	n
belgi	m
salto	n
sociologizare	f
oscă	f
novocaină	f
cantabilitate	f
acropatie	f
metalingvistică	f
psihoendrocrinologie	f
terminalizare	f
spaniolă	f
portugheză	f
patio	n
ciocul-cocorului	n
etos	n
aditivitate	f
senectute	f
areflexie	f
îngrăşare	f
ineficacitate	f
cornaj	n
epidotizare	f
respiro	n
pannaturism	n
şopăit	n
microclimatologie	f
iezuitism	n
biofenomenologie	f
craterel	m
cafeină	f
vocalism	n
roişte	f
încurcat	n
aerometrie	f
impetraţie	f
radiogenetică	f
ciliciu	n
eterificare	f
hipnologie	f
generozitate	f
diaspora	f
vechie	f
anonimitate	f
fecale	f
balzacianism	n
psihofizic	n
brahmanism	n
silogistică	f
însoţit	n
oxifonie	f
cartezianism	n
cefaloscopie	f
jăchilă	f
şuvar-de-munte	m
freatobiologie	f
gerar	m
astronomie	f
persuasiune	f
istov	n
prisosire	f
cătrănit	n
chimiluminescenţă	f
salivat	n
parodonţiu	n
alunit	n
autoînsămânţare	f
astrofotogrammetrie	f
tobralco	n
prostatită	f
păunărie	f
staticitate	f
digrafie	f
croit	n
decimalizare	f
însurat	n
ochi-de-pisică	m
metamatematică	f
tory	m
pelvigrafie	f
sistil	n
meconiu	n
arheofizică	f
dezbrobodire	f
achirofite	f
zidărit	n
omenie	f
lipăit	n
lenevire	f
deuteromorfoză	f
subfebrilitate	f
geometrism	n
adagio	n
înţărcare	f
ceramografie	f
înjghebare	f
neînfricare	f
sora-soarelui	f
disfazie	f
îndemânare	f
aniset	n
dioptaz	n
osculaţie	f
întinare	f
densimetrie	f
taciturnitate	f
defluire	f
circumducţie	f
minibaschet	n
diasirm	n
antioxigen	n
dezancorare	f
seminologie	f
pituitrină	f
electroconvulsie	f
stafaj	n
vulnerabilitate	f
esocicultură	f
scârnăvenie	f
pomeneală	f
brutalism	n
plutonier-major	m
acvatiofilie	f
tahografie	f
caretăşie	f
stadimetrie	f
fenocitologie	f
luciditate	f
rămas-bun	n
improvizat	n
încurcă-lume	f
pilocarpină	f
calabrian	n
filmografie	f
conformitate	f
peremptorietate	f
libero	m
poamele-mâţei	f
corosivitate	f
tonometrie	f
sextuor	n
dezalcalinizare	f
rezerpină	f
fonoscopie	f
plasmochimie	f
impotenţă	f
indican	n
teurgie	f
aerotactism	n
galvanografie	f
imputabilitate	f
iodometrie	f
devitrifiere	f
taro	m
termopauză	f
cărnărie	f
anilină	f
polivinil	n
onixis	n
diagrafie	f
cupiditate	f
pospai	n
tensioactivitate	f
ilogicitate	f
criptologie	f
psihopedagogie	f
estetism	n
dropică	f
crivăţ	n
ecopedologie	f
etizie	f
turnedo	n
tripartism	n
reglabilitate	f
agar-agar	n
învelit	n
litocromatografie	f
barocitate	f
pepsi-cola	f
monofonie	f
mitacism	n
steatit	n
ţarism	n
mordacitate	f
metafrast	m
aporetică	f
angelologie	f
depurare	f
cineraria	f
tânguit	n
mastologie	f
plum-pox	n
reducţionism	n
anaseism	n
colcăială	f
felinitate	f
gazbeton	n
fitochimie	f
maltază	f
endofazie	f
cafegi-başa	m
endotermie	f
biometan	n
circumspecţie	f
ultraliberalism	n
cromatină	f
vanadiu	n
transfix	n
dextralitate	f
grizu	n
absenteism	n
wilow	n
asintaxie	f
intransigenţă	f
aeraj	n
molia-zidurilor	f
paradoxologie	f
tehnirama	f
biogenosferă	f
chitină	f
fluierat	n
endogeneză	f
tempo	n
polilingvism	n
formol	n
adultomorfism	n
scart	n
română	f
metensomatoză	f
apella	f
eozinopenie	f
orografie	f
fotometrie	f
julien	n
dilaţiune	f
rechizite	f
ineluş-învârtecuş	n
cobalamină	f
doftorit	n
argol	n
argon	n
gelaţie	f
aferentaţie	f
zabet	m
serpentinizare	f
peşte-de-mare	m
hilobiologie	f
colemie	f
laminaria	f
tempera	f
hessian	n
hălălaie	f
magnetochimie	f
vist	n
maselotieră	f
fiasco	n
mongolism	n
marcat	n
etnopsihologie	f
stabilitate	f
economicitate	f
patronimie	f
stereofonie	f
bacteriologie	f
aciditate	f
nord-vest	n
ebrazură	f
antropologie	f
socialitate	f
exhibiţionism	n
multipartitism	n
chehaialâc	n
iniţă	f
înnoptat	n
himenologie	f
indiferentism	n
calciurie	f
ergotamină	f
keta	f
fleşcăraie	f
doamna-codrului	f
cvadriloc	n
filogenie	f
anamniote	f
mei-lung	m
sfătuială	f
molie-de-câmp	f
totemism	n
salubritate	f
nebunire	f
pastoralism	n
volubilitate	f
secerătoare-legătoare	f
diacronie	f
cornul-caprei	n
carboloy	n
alelopatie	f
grifaj	n
rochiţa-rândunicii	f
pantopon	n
coada-mielului	f
fasonaj	n
fasonat	n
ampelologie	f
alteritate	f
faringologie	f
endoscopie	f
zamac	n
cinescopie	f
lanugo	n
ramare	f
teritorializare	f
perisperm	n
psihagogie	f
delco	n
trupeşie	f
mizide	n
biografism	n
furmint	m
imunoterapie	f
prier	m
cinetism	n
pucioasă	f
elitism	n
divitism	n
pandecte	f
înfierbântare	f
evanghelism	n
albumoză	f
heliantină	f
miciurinism	n
rofii	f
slovacă	f
ateism	n
transformism	n
geofagie	f
tantal	n
anemofilie	f
caviar	n
scris-citit	n
mispichel	n
cosmetică	f
peşte-ciocan	m
caritate	f
linişte	f
muierce	m
refractarism	n
pancraţiu	n
magniflex	n
mineralurgie	f
cliping	n
folclor	n
fotosensibilitate	f
neîncredere	f
pietin	n
fermitate	f
făurire	f
internaţionalism	n
sânge	n
antisimetrie	f
poloniu	n
sarcologie	f
sociatrie	f
histofiziologie	f
branchipus	m
biodebit	n
oligocen	n
magnetopauză	f
pantocrator	n
mahorcă	f
similibronz	n
urobilină	f
acvatipie	f
lacs	m
codabilitate	f
spondilopatie	f
smântânit	n
naturism	n
patronat	n
hipsografie	f
vraconian	n
hepar	n
camambert	n
sarcoterapie	f
carnalitate	f
carboximetilceluloză	f
onoare	f
colutoriu	n
olimpism	n
hiperneologizare	f
fluiditate	f
verbalism	n
impunitate	f
polnoglasie	f
scaunul-Domnului	n
matitate	f
picotire	f
lapislazuli	n
grosiere	n
ebulioscopie	f
trietanolamină	f
smântână	f
inflaţionism	n
huzur	n
amorfie	f
scormonit	n
aritmografie	f
afretare	f
stereoteleviziune	f
impasibilitate	f
acrocianoză	f
folclorism	n
spectrografie	f
indiu	n
constanţă	f
ozonosferă	f
dermografie	f
rudimentaritate	f
celoidină	f
hârtie-monedă	f
feroelectricitate	f
pantografie	f
alternat	n
electrotermie	f
pâlpâit	n
aeronautică	f
perniciozitate	f
bernsteinism	n
termocromie	f
însetare	f
xilologie	f
estezie	f
microcinematografie	f
monţian	n
acolie	f
percepţionalism	n
coabitaţie	f
naratologie	f
cameleonizare	f
sonolocaţie	f
devoalare	f
smoală	f
glioxal	n
coronarită	f
asepsie	f
cucurbitacee	f
geoscopie	f
cetoacidoză	f
talmudism	n
sinistritate	f
vibrato	n
areografie	f
damaschinaj	n
dactiliologie	f
kiwi	f
îndrăznire	f
naht	n
opresare	f
stereocinematografie	f
bebe	m
mantică	f
bebi	m
contractilitate	f
culpabilizare	f
heraldică	f
secerătoare-treierătoare	f
tridimensionalitate	f
terchea-berchea	f
natrolit	m
ofit	n
adiaforeză	f
casaţiune	f
arăriel	m
netbol	n
miniaturism	n
neofascism	n
eroizare	f
particularizare	f
pangermanism	n
inchietudine	f
altimetrie	f
şinuit	n
nebeligeranţă	f
tamarix	m
misoginie	f
dinitrotoluen	n
pinax	n
franţuzească	f
ultramicroscopie	f
mercurit	n
măzăriche-neagră	f
flebologie	f
plantat	n
revent	m
enigmistică	f
bacteriofobie	f
cuminţie	f
preajmă	f
meliţat	n
clupare	f
ozeneologie	f
reticulaţie	f
remf	m
radiogeodezie	f
catalană	f
invizibilitate	f
staniu	n
stins	n
efluviaţie	f
etnodemografie	f
creştinism	n
profesorime	f
pleşcuit	n
utilitarism	n
năsăilă	m
cornărit	n
homofilie	f
lapidaritate	f
sinovie	f
pseudodebilitate	f
nepărtinire	f
morisci	m
lictar	n
poloneză	f
conglutinare	f
porumbel-râzător	m
gura-leului	f
multidisciplinaritate	f
treier	n
radicaţie	f
japon	n
rodocrozit	n
sofioni	m
japoneză	f
malignitate	f
abientin	n
năbuc	n
dacă	f
politonalism	n
tutti	n
farnesol	m
poară	f
integralitate	f
zoopaleontologie	f
comunicabilitate	f
coerciţie	f
rogodele	f
procaină	f
turbiditate	f
chivernisire	f
aboliţionism	n
caimacam-aga	m
frigotehnică	f
bogatâr	m
anarhoindividualism	n
heterostilie	f
maxit	n
menşevism	n
poliploidie	f
oxiacetilenă	f
plesnit	n
iresponsabilitate	f
zincogravură	f
înmagazinare	f
disosmie	f
muzicomanie	f
amoniurie	f
iacă	f
ţipenie	f
neurofiziologie	f
antijivraj	n
machairodus	m
speze	f
sitiologie	f
idealism	n
belugă	f
înduplecare	f
diamantină	f
ineficienţă	f
batocrom	n
trombografie	f
evaporabilitate	f
finalitate	f
cetonemie	f
acumetrie	f
reproductibilitate	f
necrolatrie	f
monahism	n
angora	f
urs-de-mare	m
stereoscopie	f
delabrare	f
abord	n
trofie	f
coliniaritate	f
corăbierie	f
ecumenicitate	f
celestină	f
băieţime	f
muiat	n
hidrargir	n
hietologie	f
hipsometrie	f
neohegelianism	n
maghiară	f
inexistenţă	f
semantică	f
alboare	f
fermata	f
radiotelefonie	f
republicanism	n
eternitate	f
preferabilitate	f
radiotelemecanică	f
lunatism	n
crupe	f
agrotehnică	f
înnoroire	f
grădinărit	n
galvanostegie	f
operand	m
condrocraniu	n
aposiopeză	f
bărbierit	n
analepsie	f
tranzitivitate	f
serializare	f
piţigoi-codat	m
fotocromotipografie	f
piratică	f
molipseală	f
jelit	n
comensualism	n
ripare	f
tripanozomiază	f
polidimensionalitate	f
lucrat	n
karate	n
cleptomanie	f
acipensericultură	f
zâmbre	f
clocaj	n
congestus	n
predictabilitate	f
post-partum	n
autoaprindere	f
pântecărie	f
ilustrativism	n
safism	n
robotologie	f
excerpte	n
brontofobie	f
noiembrie	m
ductibilitate	f
antofilit	n
diafonie	f
antracen	m
anamorfism	n
statuarie	f
fitografie	f
paraziţi	m
cuvelaj	n
patognomonie	f
vituperare	f
agrobotanică	f
ruralitate	f
enantiomorfie	f
edometrie	f
islam	n
melanterit	n
frânat	n
lenjuri	n
melanism	n
putritudine	f
brânză-n-sticlă	m
laţe	f
vezuvian	n
desmologie	f
siroco	n
muţunache	m
belită	f
protactiniu	n
globulizare	f
nepopularitate	f
celta	f
tadjică	f
heterogeneză	f
metasomatoză	f
burtăverzime	f
climatron	n
denazificare	f
tarsofimă	f
apiologie	f
apraxie	f
hepatologie	f
colofoniu	n
armoarii	f
plumbotipie	f
înseninare	f
araneografie	f
dolorism	n
laba-ursului	f
opoziţionism	m
parvis	n
penetrabilitate	f
piţigoi-pungaş	m
echidnism	n
hiperinsulinism	n
causticizare	f
învechire	f
suportabilitate	f
maţe-fripte	m
uscăţele	f
iepure-de-mare	m
ciclometrie	f
exsicata	f
fenilamină	f
ezoterism	n
clipocit	n
antiraţionalism	n
afectivism	n
traminer	n
moria	f
maieutică	f
radioascultare	f
brânca-porcului	f
eufenie	f
cato	m
seamă	f
aret	n
lagoftalmie	f
sintetism	n
constituţionalism	n
vedda	m
anoxibioză	f
năbădăire	f
galenism	n
represalii	f
instabilitate	f
eufemie	f
pârlea	m
pasivism	n
jigher	n
înfometare	f
venetă	f
virtualizare	f
dezongulare	f
bulbicultură	f
eupatie	f
apofilit	n
deziotacizare	f
beatitudine	f
conjuncturalism	n
brumărel	m
sugestionare	f
renci	n
atlantism	n
rinolalie	f
crăpat	n
peripatetism	n
tăiat	n
iarbă-deasă	f
antifascism	n
bertillonaj	n
apuntamente	n
piatră-vânătă	f
mahomedanism	n
bisexualism	n
periniţa	f
despărţit	n
suprarenină	f
boaserie	f
scafandrerie	f
zori	m
tunisiană	f
sfărâmat	n
daiboj	n
amprentologie	f
chiţăit	n
leucism	n
biomicroscopie	f
absorbtivitate	f
terilen	n
morbideţe	f
ceară	f
năvalnic	m
nituit	n
despecetluit	n
cântat	n
papistăşie	f
planimetrie	f
mefisto	m
vaporozitate	f
cuc-armenesc	m
izobutenă	f
alaun	n
eros	n
mutism	n
aerobioză	f
artroplastie	f
nacrit	n
neopsihanaliză	f
muzicografie	f
robotit	n
patronit	n
interatracţie	f
fatum	n
subtraversare	f
coezivitate	f
summum	n
şasla	f
metaliteratură	f
pancreatină	f
piezometrie	f
gastrotehnie	f
braţetă	f
miss	f
perpetuaţie	f
înspumare	f
filistinism	n
gotlandian	n
bobslei	n
epistolografie	f
pictografie	f
iatrologie	f
propilee	f
lip	n
telepreluare	f
pedobiologie	f
cosmicitate	f
deconcertanţă	f
anofelism	n
inaniţie	f
timbrologie	f
culminăriţă	f
macroetnologie	f
horticultură	f
pluriviometrie	f
polcovnicie	f
pedantism	n
apidologie	f
septicologie	f
neiculiţă	m
ison	n
perenialism	n
inconsumabilitate	f
geogeneză	f
neînduplecare	f
hematopoieză	f
exterioritate	f
anticlor	n
baleiere	f
susceptivitate	f
yterbiu	n
acribie	f
ecomimie	f
înnebunire	f
eocen	n
proteism	n
puternicie	f
numărat	n
politehnicism	n
postelnicie	f
reutilizare	f
răşină-de-pământ	f
solicitudine	f
abstenţionism	n
aminoacidurie	f
boa	m
tropologie	f
sectarism	n
obezitate	f
bilateralitate	f
euroviziune	f
hipertrofie	f
pomărit	n
paşti	f
pentamerie	f
amfibiont	n
înfierat	n
ciotcă	f
albanologie	f
bogătate	f
lizibilitate	f
soma	f
urbe	f
motorizate	n
agronometrie	f
ido	n
ide	f
universalii	f
trofism	n
panafricanism	n
raigras	n
topit	n
pecetea-lui-Solomon	f
solvat	m
azot	n
papură-roşie	f
confuzionism	n
malin	n
aerofotogrammetrie	f
reflexivism	n
oierit	n
dejojare	f
oligotrofie	f
emulsină	f
vigurozitate	f
benignitate	f
crăpăt	n
polaritate	f
calamites	n
gură-căscată	f
velocitate	f
izbutire	f
oţel-beton	n
gângăvit	n
bradul-ciumei	m
arboricultură	f
neomaltusianism	n
exstrofie	f
maar	n
izolaţionism	n
explicitate	f
zdruncin	n
hipertensiune	f
endoplasmă	f
tarama	f
agenezie	f
singenism	n
paleocen	n
ulalgie	f
incomprehensibilitate	f
paleoetmografie	f
kimeridgian	n
polei	n
colorimetrie	f
inaplicabilitate	f
verosimilitate	f
dietanolamină	f
dolerit	n
amficarpie	f
moazare	f
ofiur	m
drosera	f
endogenie	f
vâsc	m
disodie	f
medievism	n
antineutrino	m
blastomogeneză	f
monorefringenţă	f
hipocratism	n
perenitate	f
băjenărit	n
pugilism	n
reîntinerire	f
autohemoterapie	f
cramponare	f
zoonomie	f
bacteriometrie	f
cap-de-cocoş	n
acordică	f
condiţionalitate	f
capron	n
dilauden	n
politehnică	f
sultan-mezat	n
laudanum	n
iatrochimie	f
lazurit	n
polisimetrie	f
limonit	n
hipoglobulie	f
hască	f
talasocraţie	f
meru	m
platinit	n
habitus	n
etopedie	f
mitridatism	n
dragaj	n
babbit	n
altostratus	m
gravitaţie	f
dinamometrie	f
mischiu	n
petrologie	f
desulfonare	f
rezorcină	f
târnuit	n
dacoromână	f
hebelogie	f
alotropie	f
inalienabilitate	f
consangvinitate	f
spermologie	f
aglosie	f
petrochimie	f
zoomasă	f
termoterapie	f
trapezism	n
unicizare	f
siriană	f
echigravitaţie	f
asurzire	f
pediplenă	f
diatermie	f
apologism	n
nesuferire	f
isterism	n
antiumanism	n
obstetrică	f
poticnit	n
aluminizare	f
diazotipie	f
grâne	n
hidroarheologie	f
electrotomie	f
cancerologie	f
etnicitate	f
brânzeturi	n
cristalotehnie	f
trântorire	f
acetoză	f
vierit	n
ultrasonoterapie	f
arginină	f
exergie	f
penibilitate	f
glotogonie	f
puericultură	f
cobaltină	f
senineţe	f
inadaptabilitate	f
imunogeneză	f
câlţi	m
lamoste	f
moşmoane	f
embriogeneză	f
cilindree	f
cinematică	f
ecoanson	n
bastarni	m
autoepuraţie	f
elenitate	f
roit	n
poporime	f
socialism	n
martirologie	f
termoluminescenţă	f
cheilită	f
cardiomiopatie	f
compresibilitate	f
entomologie	f
contumacie	f
pertinax	n
kava	f
fototropie	f
izoalcani	m
ritualizare	f
gaudeamus	n
tenebritate	f
orizontalitate	f
molibdenit	n
banalizare	f
iscălitură	f
micetism	n
proiectil-rachetă	n
crăpelniţă	f
hexapode	n
pelagianism	n
lurex	n
margă	f
taraxis	n
pegamoid	n
panmieloftizie	f
colenchim	n
martie	m
beriliu	n
vecie	f
nutriet	n
termotropism	n
geloză	f
jargonagrafie	f
cenuşiu	n
permisivitate	f
mărgărit	m
olfactometrie	f
inalterabilitate	f
zbierat	n
albinărit	n
autocarie	f
puritanism	n
nursologie	f
etnosociologie	f
ocultism	n
rodeo	n
ranicultură	f
curabilitate	f
ecrasare	f
primat	n
africanistică	f
enoftalmie	f
ornitofaună	f
craniologie	f
gluten	n
indologie	f
aromână	f
muzeotehnică	f
wronskian	n
radiometalografie	f
turbulenţă	f
cella	f
taoism	n
ascuţime	f
rărire	f
luteţiu	n
tetrahidrobenzen	m
embriologie	f
pionierat	n
flori-de-paie	f
nevrednicie	f
krarupizare	f
zenit	n
complementaritate	f
floră	f
încălţări	f
verziş	n
ursărime	f
sibaritism	n
anahoretism	n
leucoterapie	f
complăcere	f
cristalinitate	f
oxidimetrie	f
cenobiu	n
obiectivism	n
bătrâniş	m
tipo	n
mei-păsăresc	m
erotetică	f
sugel-galben	m
căftănie	f
sezonalitate	f
experimentalism	n
fumărit	n
bromurare	f
ospătat	n
jama	f
zombi	m
obducţie	f
inscripţionare	f
congregaţionism	n
gargarizare	f
cala	f
tratative	f
fotogenie	f
alcoolism	n
saprofitism	n
antiamericanism	n
frecvenţmetru	n
protoromână	f
esofagism	n
şuşotit	n
vinilin	n
senzualism	n
balbism	n
anorganicitate	f
bioelectronică	f
capitalism	n
tehnocratism	n
ihtiopatologie	f
eucrazie	f
nopticică	f
mezozonă	f
delfinologie	f
contradictorialitate	f
intercomunicaţie	f
neprihănire	f
telefoto	n
perfectum	n
paraimunitate	f
productivism	n
crisoberil	n
antropotehnică	f
conciliatorism	n
ocratare	f
alitare	f
vogă	f
erotism	n
primogenitură	f
scopolamină	f
bombyx	m
primitivism	n
tatami	n
amiezită	f
electivitate	f
scolasticism	n
pieta	f
cromocistoscopie	f
strungărit	n
patriarhalitate	f
agrofizică	f
triumfalism	n
mielină	f
risling	n
soliditate	f
colbertism	n
aposteriorism	n
meteorosensibilitate	f
psihofizică	f
retoromană	f
orometrie	f
disemie	f
oxicarbonism	n
colonialism	n
exceptare	f
pansexualism	n
artrologie	f
textualitate	f
acromicrie	f
salpinx	n
kronprinz	m
enantiotropie	f
cretinizare	f
reflexivitate	f
deznădăjduire	f
colimare	f
şoimane	f
posibil	n
ciripit	n
baluba	m
pacfong	n
desenat	n
misticitate	f
androsterilitate	f
tămâios	n
colabare	f
halea-malea	f
tasonare	f
cecidiologie	f
viabilitate	f
credo	n
culisare	f
bonjurism	n
omnium	n
patogenie	f
tarantism	n
partenogeneză	f
italioţi	m
sahel	n
ouabaină	f
sulfid	m
papaverină	f
hipurit	m
baş	n
felendreş	n
monofagie	f
taxocen	n
concă	f
biotehnologie	f
jur-fix	n
piotorax	n
taliu	n
devirare	f
iarbă-stelată	f
osul-iepurelui	n
dijmuit	n
comparatistică	f
divaricaţie	f
giobertit	n
inactualitate	f
trialism	n
capnomanţie	f
valvulotomie	f
parnasianism	n
avantajare	f
zooprofilaxie	f
hantisă	f
mezopauză	f
potenţiometrie	f
bocnă	f
paleoastronautică	f
rongalit	n
celulită	f
învăţat	n
talasoterapie	f
destrămătură	f
spurcat	n
gustar	m
mercenarism	n
mercurare	f
duplică	f
baronarcoză	f
salicilină	f
enolizare	f
nailon	n
tripsină	f
boldo	n
lapis	n
melodramatism	n
electrosecuritate	f
şodron	n
ierhă	f
brunare	f
cranioscopie	f
auxologie	f
ecrinologie	f
scara-mâţei	f
enzimologie	f
cerithium	n
axonometrie	f
eterism	m
marxism	n
capoc	n
marabu	m
încolonare	f
maniheism	n
calicime	f
frecăţei	m
lagalism	n
limes	n
apartheid	n
amfibiologie	f
plastisferă	f
idiş	n
sifilizare	f
atomism	n
angiocolită	f
crai-nou	m
silvotehnică	f
peisagistică	f
alto	m
moţăit	n
anoxie	f
arheologie	f
cardiectazie	f
încleiat	n
perl	n
caroten	n
barbiturism	n
eburnaţie	f
casiterit	n
cristalonomie	f
vastitate	f
echivocitate	f
bazilicale	f
stomatologie	f
bovarism	n
biter	n
ca-la-Breaza	f
dezbenzinare	f
lividitate	f
geocriologie	f
rostopască	f
autometamorfism	n
vapotron	n
telalgie	f
medievale	f
hedonism	n
profetism	n
radioamatorism	n
micromicete	f
omet	n
inerenţă	f
ciormoiag	m
alcoolat	m
îndumnezeire	f
alogeneză	f
cariologie	f
subestimare	f
probiont	m
poliandrie	f
aseismicitate	f
tracă	f
ţâţa-oii	f
cofeină	f
californiu	n
orologie	f
cezanism	n
poturei	m
osteogeneză	f
mentenabilitate	f
coifură	f
medievalitate	f
arenizare	f
cioandă	f
încreţit	n
brahistocronă	f
cicloturism	n
pustnicie	f
bolşevism	n
flotabilitate	f
păienjenire	f
sud-vest	n
metilcetonă	f
dubire	f
capitalband	n
anghinare	f
impenetrabilitate	f
urogastronă	f
călărie	f
nilvar	n
plutit	n
călărit	n
teină	f
ecleziologie	f
oprobriu	n
cal-de-apă	m
etnofobie	f
zel	n
amfimixie	f
glicometrie	f
decoafare	f
poale-n-brâu	f
şcolaritate	f
fenobarital	n
declampare	f
secentism	n
cafeism	n
panelenism	n
geometrie	f
includere	f
amurgit	n
cozondraci	m
politologie	f
adamască	f
delirium	n
bromism	n
dadaism	n
regina-peştilor	f
tabes	n
tanatogeneză	f
paleofitologie	f
tanatologie	f
disforie	f
cocainism	n
tendenţionism	n
pap	n
baga	f
halocromie	f
provizoriu	n
cronicitate	f
cronicizare	f
frământat	n
engramare	f
stereostatică	f
tiflosurdologie	f
clotoidă	f
logetron	n
extrateritorialitate	f
mov	m
bogomilism	n
guanaco	m
orăşenime	f
planetologie	f
neavere	f
digerare	f
moderato	n
geodezică	f
ocru	n
rutină	f
impudenţă	f
cresus	m
galenţi	m
tehnologizare	f
chitonag	n
cenobitism	n
altoit	n
filicologie	f
uraninit	n
astatizare	f
canotaj	n
tiflotehnică	f
cearter	n
heiuri	n
refractare	f
scientică	f
spinarea-lupului	f
deferlaj	n
perisologie	f
gore	f
procedibilitate	f
fosfagen	n
levizită	f
amilodextrină	f
fluviu	n
geriatrie	f
naftă	f
dilatometrie	f
antropogeneză	f
micrologie	f
cabotinaj	n
sorcovit	n
ineluctabilitate	f
petrolism	n
stărostit	n
concentricitate	f
militărime	f
encefalografie	f
transtrav	n
toriu	n
octupleţi	m
grobianism	f
kappa	m
galactogeneză	f
strigat	n
permutabilitate	f
planeitate	f
hematologie	f
citoarhitectonică	f
elocinţă	f
eligibilitate	f
ancestralitate	f
anglie	f
unanimitate	f
rapsodiere	f
silvicultură	f
muierime	f
curaj	n
coptologie	f
splenectomie	f
arpentaj	n
electrodrenare	f
cabriol	n
diaplegie	f
blazare	f
felogen	n
călţunul-doamnei	m
împovărare	f
roshar	n
deductibilitate	f
semicolonie	f
artistism	n
antidogmatism	n
calemcheriu	n
dialectologie	f
melinită	f
sirex	m
bacala	m
solipsism	n
incorigibilitate	f
onanism	n
minioină	f
demonomanie	f
barbital	n
pantotermie	f
vasalitate	f
osteogenie	f
explozibilitate	f
aportare	f
cadmiu	n
capitălaş	n
yorkian	n
unghia-găii	f
porto	n
hipotrofie	f
ascochitoză	f
electroluminescenţă	f
proză	f
plebeianism	n
vetustate	f
creştinătate	f
apomixie	f
interviziune	f
gluciniu	n
narativitate	f
yohimbină	f
varga-ciobanului	f
consociaţie	f
tensiometrie	f
esperantism	n
nucă-galică	f
porc-de-mare	m
vântură-lume	m
adăpat	n
pedigriu	n
pelioze	f
zugravit	n
demantelare	f
tonicitate	f
impracticabilitate	f
elaborat	n
melifere	f
cilindrurie	f
fine	n
silmanal	n
kabili	m
caudillism	n
informating	n
perfectibilitate	f
orca	f
cerbice	f
adrenocrom	m
difosgen	n
geomorfism	n
câlţisori	m
egutare	f
sodiu	n
suportare	f
rezidualitate	f
lacunarism	n
jabă	f
zooterapeutică	f
obstrucţionism	n
farmacofobie	f
colportare	f
pahinoză	f
bismutit	n
telemetrie	f
bizantinistică	f
ravac	n
hiperglicemie	f
benga	m
furioso	n
cosmozoologie	f
marginalism	n
imperialism	n
cerul-gurii	n
dunit	n
osteografie	f
eleusine	f
hilofobie	f
suliţică	f
biocriminalistică	f
autogeneză	f
complementarism	n
sulfhidrism	n
brăhnit	n
canabicultură	f
narcotropism	n
opacimetrie	f
fagoterapie	f
electrocinetică	f
extremism	n
guşa-porumbului	f
tată-mare	m
octombrie	m
fenilalanină	f
ghilit	n
reclamare	f
ultranaţionalism	n
hiperprotejare	f
pârg	n
electrofiziologie	f
tetraedrit	n
decurionat	n
posesivitate	f
turbieră	f
incompatibilitate	f
piromanţie	f
zulie	f
rontgenterapie	f
nomadism	n
anticalofilie	f
pedologie	f
calico	n
vărsat	n
janilie	f
biofizică	f
saturnism	n
curăţat	n
geospeologie	f
ţârfă	f
crenobiologie	f
lene	f
impecabilitate	f
papa	m
demonologie	f
stereochimie	f
paranoism	n
canibalism	n
tetrahidronaftalină	f
vibrioză	f
aerocartofilie	f
anergie	f
fumăraie	f
nubilitate	f
coraslă	f
rantoalare	f
alolalie	f
turnesol	n
electroconcentrare	f
stereocartografie	f
gândit	n
nabism	n
limba-oii	f
forsterit	n
înserat	n
populism	n
silit	n
vtori-logofăt	m
febrilitate	f
tetras	m
antiseptizare	f
ponit	n
chemozis	n
recidivitate	f
corealitate	f
sita-zânelor	f
spalax	m
mitologism	n
disciplinaritate	f
detur	n
bornit	n
ofidism	n
ridicat	n
ismailiţi	m
azbest	n
fuzel	m
vlavie	f
dromfobie	f
poligeneză	f
sadomasochism	n
etnocivilizaţie	f
patinat	n
cromozomologie	f
trombozare	f
ascensionare	f
gustativitate	f
cardamon	m
verminoză	f
arborare	f
geolatrie	f
reabsorbţie	f
insalubritate	f
acologie	f
husărime	f
mezotorace	n
intertrigo	n
iţari	m
demontat	n
setbol	n
chişleag	n
mortalitate	f
ofidiotoxină	f
vântură-ţară	m
ultracentralism	n
empireu	n
dovedire	f
vedetism	n
anticolonialism	n
nilgau	m
acrofobie	f
romanţiozitate	f
zarzuela	f
masicot	n
ergotinină	f
coate-goale	m
irealism	n
mimansa	f
inocenţă	f
leucodermie	f
aristotelizare	f
cortizon	n
bălăbănit	n
fordism	n
fasciaţie	f
angelolatrie	f
argăţie	f
geocentrism	n
onctuozitate	f
vitron	n
compenetraţie	f
strujit	n
chiaburime	f
fadoare	f
asfaltene	f
venografie	f
manitare	f
ecuant	n
smalt	n
vernalizare	f
şlaif	n
pedosferă	f
rerecording	n
poporaneitate	f
cerit	n
ceriu	n
hilozoism	n
naga	m
dramaturgie	f
ginecologie	f
raptus	n
politichie	f
anason	m
rusofonie	f
cicero	m
piretologie	f
garantare	f
adventice	f
cliring	n
părul-porcului	m
văduvire	f
astazie	f
teomahie	f
feculenţă	f
edilitate	f
conductometrie	f
alchilare	f
acetonemie	f
decuspidare	f
malarioterapie	f
nefalism	n
mafie	f
poliacetat	m
cartofilie	f
candoare	f
celofanare	f
talonaj	n
enoterapie	f
panarabism	n
ecluzare	f
fetalizare	f
culisou	n
storax	n
elastomecanică	f
dakotas	f
electrotropism	n
decretare	f
schimbat	n
bibliolatrie	f
iod	n
sete	f
malaga	f
miologie	f
doi-dinţi	m
atonism	n
sihăstrire	f
picurat	n
supraexploatare	f
narcoterorism	n
coraciforme	f
ectopie	f
binaritate	f
lupin	m
plauzibilitate	f
somali	f
enocianină	f
chemotropism	n
creatinemie	f
portretistică	f
electrometalizare	f
taurischi	m
frugalitate	f
soft	n
trai	n
ostracism	n
termalitate	f
stronţiu	n
nevroscleroză	f
cusut	n
comuneros	m
conservatism	n
spin-muscălesc	m
lamură	f
histologie	f
preformism	n
cerografie	f
bacteriană	f
guanină	f
divizibilitate	f
glicerină	f
căişori	m
pancultură	f
quolibet	n
diafanitate	f
impenitenţă	f
duro	m
fecral	n
topoclimă	f
cruţare	f
eseistică	f
kraft	n
perforat	n
negativare	f
virilism	n
bartonian	n
bacteriofagie	f
moralitate	f
satinet	n
paria	m
lombardare	f
calcit	n
calciu	n
verif	n
venus	f
bacovianism	n
eclectism	n
sârbocroată	f
ciobănie	f
uranologie	f
antropospeologie	f
mercurism	n
şarpe-de-apă	m
dezanamorfoză	f
adenologie	f
nucleaţie	f
neonazism	n
sicitate	f
avional	n
artralgie	f
iconoclasm	n
clavicembalo	n
monolitism	n
microfizică	f
farmacovigilenţă	f
zvârlet	n
lateritizare	f
burghezime	f
silvaner	m
rontgenologie	f
henry	m
ocăit	n
cromism	n
eczematizare	f
coluviu	n
izomorfism	n
buna	f
nebuloasă	f
emancipare	f
hidrolacolit	m
încarbonizare	f
hipnotism	n
iconoclastie	f
ardenţă	f
stronţiană	f
caricografie	f
informitate	f
climatism	n
over	n
cortil	n
desublimare	f
analistă	f
mertepea	f
omorizie	f
ebenit	n
fârtăţie	f
volubilism	n
ciocul-berzei	n
meglenoromână	f
saturaţie	f
gonio	n
oogamie	f
nitrobenzen	m
asfaltaj	n
troposferă	f
pitire	f
organologie	f
situaţionism	n
auriga	m
stufit	n
esperanto	n
înfăşurătoare	f
achinezie	f
hermeneutică	f
hirsutism	n
azbotextolit	n
crin-galben	m
tricromie	f
celadon	n
catastrofism	n
izogamie	f
inanitate	f
ortoptică	f
echitaţie	f
fălţuit	n
adiabatism	n
colografie	f
îngrijare	f
plutoniu	n
curiu	n
fosforism	n
bioinginerie	f
metan	n
veresie	f
subdezvoltare	f
tetrafluorură	f
papucul-doamnei	m
comină	f
frecat	n
cromofotografie	f
kaki	n
agramaticalitate	f
periclaz	n
mergere	f
românistică	f
tritiu	n
aeropatie	f
ultraacustică	f
paravint	n
buldo	n
calmitate	f
gamologie	f
fotoelasticitate	f
radioactivitate	f
recurgere	f
neuroplegie	f
ajuns	n
pedopsihiatrie	f
antivoal	n
purtat	n
guanidină	f
calanco	n
prisăcărit	n
poltronism	n
aracceevism	n
montmorillonit	n
microfloră	f
coşolină	f
şofat	n
sceleratism	n
marigot	n
pugilistică	f
mazăre	f
aţică	f
bombasticitate	f
poala-rândunicii	f
rotunda-puturoasă	f
diaulă	f
nazareeni	m
angiofluorografie	f
rahitism	n
discernere	f
subconştienţă	f
adhocraţie	f
eunucoidism	n
casting	n
gheizerit	n
spirantizare	f
telematizare	f
radioastronomie	f
necesar	n
pişcat	n
uscăciune	f
ledian	n
solitudine	f
dictiocauloză	f
calembec	m
polisintetism	n
diplomatică	f
calviţie	f
anoxemie	f
coagulabilitate	f
buciardare	f
empiriomonism	n
natriu	n
pravoslavnicie	f
anceps	n
nataţie	f
bălăngăit	n
hagiografie	f
mohorâre	f
ţâţa-caprei	f
uvologie	f
scheletologie	f
despotism	n
negrilă	f
singenetică	f
antracoză	f
erotică	f
metamerism	n
radionavigaţie	f
robusteţe	f
crucea-pământului	f
pirometamorfism	n
neaplicabilitate	f
alcalinitate	f
patomorfologie	f
melos	n
gongorism	n
arcoză	f
hafalgezie	f
melod	m
bionomie	f
oligoclaz	m
mixte	f
succesibilitate	f
nefroragie	f
biocentrism	n
talpa-gâştei	f
sulfatiazol	n
balneologie	f
spectaculozitate	f
blanşiruire	f
coz	n
gură-bogată	m
intervenţionism	n
interasistenţă	f
măcănit	n
psihoimunologie	f
anisidină	f
aplanetism	n
popime	f
ficologie	f
golănime	f
ţesălat	n
izodinamie	f
neoboseală	f
biotaxie	f
sequoia	m
zigogeneză	f
vinil	n
radon	n
căpitan-paşa	m
veterinărie	f
pasivitate	f
curăţie	f
mecanică	f
gimnosofie	f
stoichiologie	f
ridare	f
cimbrişor	m
electrochimie	f
indigenţă	f
ochloraţie	f
privit	n
cognaţiune	f
duplen	n
campanian	n
oleomargarină	f
citadinism	n
cecografie	f
oratorie	f
debandadă	f
telediafonie	f
ampelopsis	m
inconel	m
trasaj	n
ucigă-l-toaca	m
selenografie	f
nicotinism	n
horcăit	n
convenţionalism	n
englobare	f
vitallium	n
endoradioterapie	f
farmacofilie	f
colocvialitate	f
diene	f
fizică	f
flăcăraie	f
arhaizare	f
pseudohermafroditism	n
faustbal	n
bornaj	n
controlabilitate	f
teledinamică	f
kiloampermetru	n
nivoză	f
hidrogen	n
tăieţei	m
paleopsihologie	f
ohrană	f
antropofilie	f
lactoduc	n
însemnătate	f
pretenţiozitate	f
liur	n
palmitină	f
tifobaciloză	f
scandiu	n
bicentenar	n
acteonela	f
lirism	n
agroclimatologie	f
codire	f
filatelie	f
oligantropie	f
toci	n
toco	m
năglag	n
gastrolatrie	f
endosmoză	f
antropocentrism	n
misiologie	f
semistabulaţie	f
surzire	f
termotehnică	f
frotir	n
actinotropism	n
dinţărit	n
bibliotehnică	f
gravitare	f
zeamil	n
fatuitate	f
calcedonie	f
betaterapie	f
dicromatopsie	f
antimemorii	f
tetanos	n
coma	f
rezumare	f
paroxitonism	n
laptele-cucului	m
harţi	m
speciaţie	f
indisciplină	f
coada-mâţei	f
onirism	n
stricteţe	f
harţă	f
oripilaţie	f
botulism	n
lumbago	n
arhivotehnie	f
farmacogenetică	f
monotematism	n
macroeconomie	f
pseudofonetism	n
ontologie	f
dacian	n
brucină	f
cotonizare	f
turbionare	f
kilt	m
elasticitate	f
kiln	n
astenologie	f
îmbrăcat	n
turta-lupului	f
descătărămare	f
ovalitate	f
piromorfit	n
clănţănit	n
muzicologie	f
globalitate	f
compactibilitate	f
mentă	f
taroc	n
lekytos	n
francofonie	f
omotermie	f
egrenat	n
cronopatologie	f
goniometrie	f
cărturărie	f
pseudomnezie	f
Bundestag	n
fleuretis	n
anesteziologie	f
sitosterol	m
depresivitate	f
donjuanism	n
bucate	f
alait	n
geamparale	f
electrometrie	f
cinema	n
vulg	n
portland	n
anaerobioză	f
ghimbir	m
aspergiloză	f
cheratoză	f
sociocentrism	n
frăţietate	f
comizeraţie	f
arhimandrie	f
prolegomene	n
demiurg	m
tapiocă	f
rafinoză	f
tiflografie	f
peonia	f
diiodotirozină	f
centrosferă	f
chirpici	n
mecanotehnică	f
automulţumire	f
devonian	n
uree	f
fai	n
mehterbaşa	m
pleistocen	n
scriitorime	f
cazarmament	n
liturgică	f
arteriectomie	f
amielie	f
limnifon	n
supraexcitaţie	f
epicizare	f
ozon	n
tămâie	f
amploare	f
oprit	n
menţinere	f
geotermometrie	f
paleospeologie	f
expresionism	n
mezosferă	f
textologie	f
plonj	n
tiflopedagogie	f
înceţoşare	f
pasifloral	n
taică	m
hidronimie	f
ogorât	n
tapioca	f
azotobacter	n
abitaţie	f
voltairianism	n
tranzacţionare	f
neverosimilitate	f
cenestezie	f
măritare	f
orchestrino	n
stereocromie	f
aproximativitate	f
scientism	n
tarabostes	m
tetracromie	f
miscibilitate	f
parasexualitate	f
sincronogamie	f
psitacism	n
incognoscibilitate	f
sacom	n
tocologie	f
sit-in	n
gagat	n
erborizare	f
criochimie	f
isihie	f
vivifiere	f
etan	m
negustorime	f
vinişor	n
penicillium	m
stratus	m
calmare	f
întors	n
rodografie	f
primitivitate	f
iazigi	m
barba-lupului	f
tipicizare	f
covarianţă	f
ludism	n
filabilitate	f
cloritizare	f
lamelibranhiate	n
frăţică	m
rabinism	n
galb	n
diaconie	f
exponenţialitate	f
cosmonomie	f
fresco	n
legumină	f
zeină	f
dislalie	f
înregimentare	f
savantism	n
perspicacitate	f
insularitate	f
umor	n
acriş	n
deltacism	n
fixaj	n
albigenzi	m
stepizare	f
colostru	n
intermedină	f
amarinare	f
prunduţ	n
afagie	f
asfaltit	n
sura	f
zimotehnică	f
solanină	f
fotochimie	f
bărbăţoi	m
idiocromatism	n
ovăzcior	n
entomogamie	f
ocopaţie	f
social-democraţie	f
supletivism	n
siluminit	n
dibuit	n
obştime	f
dezaclimatare	f
congenitalitate	f
congeneritate	f
partitiv	n
barba-caprei	f
gastronomie	f
rubricatură	f
variolit	n
grena	m
gramatologie	f
cumulus	m
miniu	n
transigenţă	f
răposat	n
cianotipie	f
endomorfină	f
cumpătare	f
anulabilitate	f
palux	n
boronit	n
epandaj	n
metil	m
dumă	f
astrografie	f
ceruleu	n
orientalism	n
hipologie	f
sufism	n
comandare	f
cromnichel	n
catari	m
panslavism	n
retrodeviaţie	f
stomatolalie	f
câinoşenie	f
gentileţe	f
condensabilitate	f
gândăcărie	f
rachetomodelism	n
chesat	n
integralism	n
brum	n
cromatogeneză	f
drajare	f
muzeistică	f
abioză	f
fonofobie	m
vermillon	n
egipteană	f
benziliden	m
palisaj	n
cardiometrie	f
râşnit	n
limnobiologie	f
homogamie	f
bronhologie	f
pedofilia	f
şeviot	n
birocratism	n
bilirubină	f
acridologie	f
karma	f
spumă-de-mare	f
osărie	f
torit	n
kieserit	n
infantilism	n
şistozitate	f
clericalism	n
hinduism	n
ravenare	f
oleicultură	f
enoptromanţie	f
rotărit	n
cubatură	f
habronemoză	f
augit	n
primenit	n
frenologie	f
pantofobie	f
spanac-englezesc	n
făcăluit	n
sluj	n
selemet	n
ihtiol	n
ptialism	n
corindon	n
cosmopatologie	f
faunistică	f
conductivitate	f
schingiuit	n
braunit	n
culteranism	n
teleradiografie	f
telegnozis	n
maculare	f
cornul-dracului	n
oratorism	n
răzbatere	f
defloculare	f
metalofobie	f
talpa-stâncii	f
sticlărit	n
guru	m
contoar	n
creaţă	f
microbism	n
anafie	f
albanistică	f
iudeospaniolă	f
silitră	f
rugul-vacii	m
alchidal	m
paternoster	n
mlecin	m
lăudare	f
fludor	n
infracţionalitate	f
drăgănele	f
gangliocultură	f
quakerism	n
evolutivitate	f
benevolenţă	f
euclaz	n
popularitate	f
ţipirig	n
euristică	f
radiogoniometrie	f
înflăcărare	f
ioniu	n
citobiologie	f
ciclism	n
astrafobie	f
ţâşti-bâşti	m
geomagnetism	n
condriozom	n
slavistică	f
maţe-negre	m
croncănit	n
locă	f
docilitate	f
audiologie	f
salieni	m
mătreaţă	f
măcinat	n
detersiune	f
căpătat	n
braişvanţ	n
civilitate	f
anafilaxie	f
hidromecanică	f
omenime	f
şintoism	n
ornare	f
geomanţie	f
libertinism	n
zoochimie	f
ilicitate	f
biologie	f
naumahie	f
vivificare	f
galofilie	f
denatalitate	f
egirin	n
astrobiologie	f
dactilofazie	f
pastelistică	f
cloral	n
regizorat	n
telescopare	f
sineală	f
sughiţat	n
sinonimică	f
sterilitate	f
yardang	n
veneraţie	f
econometrie	f
conabiu	n
turcă	f
nefralgie	f
violet	n
olfactorium	n
configurativitate	f
cupru	n
sociobiologie	f
electrodinamism	n
cola	m
geneziologie	f
spoit	n
rujet	n
memento	n
biocosmonautică	f
funcţionalism	n
aduct	n
toxicologie	f
mnemotehnie	f
inventică	f
democratism	n
fenantren	n
ceasoficare	f
pliocen	n
rostogolit	n
rândunică-de-mare	f
mătăsică	f
scalare	f
muzeologie	f
detractare	f
iuncherie	f
hipodermie	f
cotiledonate	f
wild	n
clampare	f
zacherlină	f
hispanism	n
bioclimatologie	f
piscicultură	f
desfăşurătoare	f
agrostografie	f
autognoză	f
hale	f
lapte-de-pasăre	m
brahicefalie	f
intuiţionism	n
codicologie	f
tremurat	n
bismutism	n
derocare	f
simplicitate	f
stenotipie	f
sica	f
şuşuit	n
problematică	f
fosfocreatină	f
sodă	f
empire	n
silabisit	n
mezonephros	n
răpciune	m
dozimetrie	f
vremelnicie	f
crengăraie	f
clinicism	n
tocănit	n
ultramontanism	n
brust	n
sovietism	n
dezbărare	f
contractibilitate	f
fitotomie	f
flăcăime	f
izosporie	f
caolinizare	f
quechua	f
coree	f
scepticism	n
laceraţie	f
diafanie	f
omeomorfism	n
tetraclormetan	n
trioleină	f
groscior	n
crestoscopie	f
pişcă-n-floare	m
anrobare	f
transmisibilitate	f
termofobie	f
gap	n
antirasism	n
cleveit	n
păşunare	f
emeri	n
